20,20
....@..@............
..................@.
....@..@@....@.@....
.........@.@...@....
....@...............
@..................@
@..........@........
.@....@.......@.....
...@........@@......
.................@..
..................@.
.@..@...............
....@........@......
.........@....@.....
.....@....@...@.....
...@..@.............
..@.................
....................
....................
.........@@.....@@..
