20,20
..........@.........
...@................
..........@......@.@
............@.@.....
....@......@........
....................
@......@...........@
....@...@@....@.....
.....@.......@....@.
................@...
........@.........@.
....................
......@......@......
@....@@@........@...
.....@.@.@..........
....................
.@...@..@...........
.@.................@
................@...
.@.............@....
