20,20
................@...
...............@.@..
..............@.....
@.......@.........@.
....@...............
.......@...@..@...@@
..................@.
...........@.....@..
..@.....@@.....@....
...............@..@.
@..@.........@..@...
...@......@.........
...........@........
@...................
......@.....@.......
..............@.....
..@....@........@...
.......@............
......@@............
........@...........
