20,20
..@.................
...............@@..@
@...............@..@
....................
..........@@........
..@.........@.....@.
@.........@....@....
......@............@
....@...@...@.......
.....@..............
.@..................
....................
....@...............
...@...@@...@@......
............@.......
@..............@....
@.......@........@..
@...................
.....@..............
.......@.@....@..@..
