20,20
.@......@.......@...
..@....@............
..........@.@......@
...........@.@...@..
....................
....@..........@....
...........@........
....@..............@
....................
.@.........@@.......
..........@.........
..@.....@..@....@...
........@...........
....@@.....@....@...
.@.@................
................@@..
.@..............@...
.@........@....@....
..............@.....
...................@
