20,20
.....@..............
.......@............
......@.............
....................
.@.......@..........
..............@..@..
...........@.....@..
...................@
......@.....@@......
...@.....@..........
..@..@..............
......@......@@....@
..............@...@.
..............@@....
..@...@....@........
....................
....@@.@...@....@...
......@........@.@..
.@............@@....
........@...........
