20,20
..............@.....
............@.......
@.......@...........
.......@...@@.....@.
......@...@......@..
....................
..@.@.....@.........
.....@@.......@.....
........@......@....
....................
...............@....
....@...........@...
...@.@@.....@.......
......@.............
@...................
...@.@..........@..@
...........@....@...
.@..................
.@..................
.@...@.@..@.........
