20,20
....................
....@.....@@........
...........@.....@..
.........@@...@@....
@.........@.........
.@...........@.....@
...@........@@..@...
.....@..............
.....@.@...@........
..................@.
@...@...@..@......@.
...........@.....@..
.@...@..............
..................@.
...........@@....@..
....................
.@..................
..............@.....
....@...............
..................@.
