20,20
.......@...@......@.
.....@............@.
..........@.........
......@..........@..
.......@..@.@....@..
....@..........@....
..@.................
....@............@..
......@...@.........
.@.......@..........
....@........@......
.......@........@..@
....@..............@
..............@.....
..@.................
.................@..
.......@@...........
...@................
.@.......@.@@.......
@..............@....
