20,20
.....@@.............
..................@.
...@.....@....@.....
....................
..............@.....
......@.......@.@...
.@.....@@.....@.@...
....................
...................@
................@...
.........@.@........
..........@.@.......
.@.@..@.............
...@..@...@.........
..........@......@..
.@....@.........@...
.........@......@@..
.................@..
.@.....@............
........@.........@.
