20,20
@...................
.....@.......@....@.
.@.......@..........
....@.@@............
..........@.........
....@@..............
.@......@...@.....@.
............@.......
....................
..@.............@...
@...@@.....@.@......
.......@............
..@....@............
..@@.....@..........
....................
@................@@.
.......@@....@......
....................
...@...@...@........
@...................
