20,20
.............@@.@..@
...@................
...@.@........@.....
@.@...........@.....
.....@..............
.@....@.............
.....@@...@....@.@..
............@.......
.............@.@....
.......@............
.........@..........
....................
.@..................
@..........@.@......
....................
...@.............@@.
@.....@...@....@....
................@...
.....@.......@......
.......@........@...
