20,20
...@........@.......
..................@.
.@..................
..@@............@...
...........@....@.@.
.................@@.
..@.......@...@@@...
............@.......
..@....@@....@......
..............@.....
......@.............
...@................
.................@..
...@..@@....@...@...
.@......@@.........@
....................
....................
.........@.@........
.@............@.....
....@...............
