20,20
@...@........@......
.@.....@..........@.
......@..@@...@@....
..............@.....
.......@@.@.......@.
....@...............
....@.........@.....
....................
....................
................@...
.............@......
....................
....@.....@....@..@.
...@@.@.............
.@....@.........@...
....................
.................@..
...........@........
..@......@.@..@@.@..
....@...............
