20,20
.......@............
.@.@..@.............
....................
..@@.@..............
...............@....
..........@.........
...............@.@@@
......@.............
...@.....@...@@.....
..@@@..@............
........@........@..
....................
....@.@..@..........
..............@.....
.....@..............
......@......@.@@@..
..@.................
.............@......
...........@........
......@.......@@....
