20,20
....................
........@..........@
...@..@..@.@........
....................
......@.............
....................
....................
.....@@.....@.@.....
..@...@.@..@........
...@...@...@...@....
.................@..
........@......@....
..@.@@..............
....................
......@......@......
..............@@..@.
....@......@..@.....
...@@..@............
.....@..@...........
................@@..
