20,20
......@@......@.....
.....@........@...@.
....................
..@.........@......@
.........@..........
...................@
....@..@@..@......@.
........@.@@.....@..
.....@...........@@.
....................
.............@......
.@..........@.@@....
..........@.........
.........@..........
..........@....@.@..
....@...............
@...................
....................
.........@........@.
@.......@....@......
