20,20
....................
...........@......@.
@..@................
....................
............@.......
.......@.@..........
@.....@........@...@
..@.@...............
.............@......
..................@.
@...@...............
@.....@@......@.@...
..@@........@.......
.......@....@.......
.@.@............@.@.
...@..@.............
..........@.........
....................
..@....@...@........
.@...........@...@..
