20,20
....@...@...........
....................
.................@..
..@@@@..............
..@...@.@...........
..............@.....
..@.@...............
............@.......
......@.@.@.........
...@............@...
....@..............@
.@...........@..@...
@@..@..@............
.@..@.........@.....
..................@@
........@...........
...@....@@.@........
................@...
....................
.@..................
