20,20
@......@......@.....
.............@......
.............@......
...@.....@...@..@...
...................@
......@.............
.........@...@...@..
..........@..@...@..
...........@.@.....@
....................
.............@......
.......@...........@
..........@.........
.@...@..............
@..@...............@
....................
.....@..........@..@
.....@........@@....
.....@........@.....
.....@......@..@....
