20,20
.....@..............
....@..........@...@
.........@@.....@...
........@@..........
.@....@.............
.........@..........
....@............@..
.............@......
..@...@..@.......@..
..............@.....
.........@......@...
..@.@.............@.
.............@......
........@....@......
....................
.........@.....@....
..@............@....
..@..............@.@
...............@.@..
...@@...........@...
