20,20
.............@......
......@.@@@.@.......
.......@............
@...................
.@..................
.....@.....@..@..@..
@..@................
........@..@........
...........@...@....
.@..................
....................
@...................
...................@
@.....@........@..@.
.....@........@.....
.@..................
.....@@............@
........@......@....
...........@@.....@.
.@@...........@.....
