20,20
..@................@
...@....@........@..
...........@@.....@.
.................@.@
.......@...@........
........@......@....
.@.............@..@.
@.......@....@......
......@..@.......@.@
....................
...@...@.........@..
....................
....@...@...........
.................@@.
....................
....@............@..
....@@.....@........
....................
..................@.
.......@.....@...@..
