20,20
....@..@.........@..
@...................
.@@@......@.@.......
..@....@.@...@..@.@.
.....@......@.......
......@.@..@........
...@.@........@.@...
......@.....@...@...
....................
...................@
....................
....................
........@@..........
....................
.@.@................
..................@.
.@.@..............@.
@...@.......@.......
.@..................
....................
