20,20
..........@.........
....................
@.@@@.@.@...........
....................
@...................
@........@.......@..
.@...@..............
...........@.....@..
.......@.....@......
..............@.....
....................
.....@...@......@...
.................@..
...@..@.............
....@...@...........
...........@......@.
............@@.....@
@@....@@............
..@.................
........@@.@..@.....
