20,20
.@..................
..@.................
.............@......
.....@..@@.@....@...
....@...............
.................@..
......@....@........
.@.........@........
.@......@...@.......
.....@......@@.....@
.....@........@..@..
...@@....@..........
...............@....
........@...@.......
...@.........@......
...........@........
......@.@....@......
@...@...............
....................
.....@............@.
