20,20
...@......@...@.....
.........@..........
....@.............@.
....................
.@..................
.........@...@.@....
....................
.........@.......@..
......@.@...........
..@...@.......@....@
.@.......@.......@..
....................
.@....@.....@.@.@...
.........@..........
.....@......@..@.@..
........@...........
......@.@@..........
...@@..@.@..........
....................
........@...........
