20,20
@@.......@..........
...............@...@
..@............@@..@
.........@@.........
...@@@..............
............@@......
........@...@.......
...............@....
....@..@.....@......
...@................
..@.................
@............@.@@...
........@...@....@.@
.......@......@.....
.......@............
........@...........
....@..........@....
....................
............@.......
...@................
