20,20
...@@...............
........@...........
....................
...............@....
....................
......@.............
...@................
.@..........@.......
....@...............
..@@@...............
..@.....@...@.......
..@..@@.......@....@
....@....@.........@
...@....@@...@......
.....@.............@
............@.......
.@............@@....
......@@..@........@
....@..........@....
............@.......
