20,20
....................
....................
.............@......
....@..........@@...
...@..@.............
....@.......@.......
.@....@.@...........
...........@...@....
...@.............@..
...@..@..@.........@
...............@....
......@.....@@......
..........@..@......
....................
...@................
.....@@.............
.......@.@..........
..@..@............@@
.....@.....@.......@
.....@..@...@.......
