20,20
.@..................
....................
...@........@.......
.@........@.....@...
....................
....@@.....@........
.........@..........
..@.................
@....@........@.....
......@..@@.........
.....@.....@........
.@......@...........
......@..@..........
....................
@.@...@.......@.....
..@.......@......@..
.@.............@....
.....@......@..@@..@
.@.............@.@..
....................
