20,20
..@.@...............
.@......@..@........
.@..................
.......@.....@......
....................
........@...@.....@.
..@..@..@...@.......
.......@..@.........
..........@.....@...
...@................
....................
....@.....@..@......
.......@...@........
................@...
..@.@....@.......@..
...........@......@.
..........@.........
....@.@.....@.......
...@....@...........
..@.............@...
