20,20
................@...
...@......@........@
..........@.........
.....@@.............
..@....@............
....@...............
..@.@.......@.......
....@...@....@....@.
....................
@.......@@...@......
.........@...@..@...
.......@....@.......
........@....@......
.........@..........
.......@............
...@................
..........@...@.....
....@....@...@..@@..
....................
...........@.......@
