20,20
@..................@
........@@..........
....................
......@.........@...
....@..@...@........
................@...
.@@.................
@...@..@.@...@.@....
@.@.@.........@.....
...@.@..............
.....@..............
@..................@
....................
....................
...............@....
.@.............@....
........@.@...@.....
.........@.@@.@.....
......@.............
..@.....@...........
