20,20
....@.....@........@
....................
............@.......
.......@............
.............@.@....
.@........@.....@...
.....@....@........@
@......@..@@........
...........@........
......@.............
......@.............
..@.............@...
.....@....@.....@..@
@........@..........
..@.............@...
@......@@@..........
.......@..........@.
.........@..@.......
.....@.........@....
....................
