20,20
....................
...........@@.@.....
............@.......
.@...@........@.....
..@.@...........@...
......@.......@....@
.........@....@.....
.........@........@.
...............@....
@...................
..@.@.@@..@.......@.
.........@.@........
...........@........
@.............@.....
........@....@......
....................
....................
.............@......
.........@@.......@.
.@....@........@...@
