20,20
....................
.......@.........@..
.......@@...@......@
.................@..
...@................
.........@....@.....
....................
.......@.........@..
...@@...............
..@.@.....@..@......
.................@@.
.@..@....@..@..@....
....................
...................@
....................
@........@....@.....
.....@.@.....@.....@
..............@....@
...@......@@@.......
.........@..........
