20,20
..@...@@...@......@.
@....@....@.........
..............@.....
....................
......@.@...@.....@.
......@..@...@.....@
..............@.....
.............@......
.........@..@@......
.@@..@.............@
.....@...@..........
....................
......@...........@.
.........@..........
..@.......@.........
....................
....................
@.@......@......@...
@...................
@.....@.............
