20,20
...@................
...@................
........@......@..@.
....................
.@....@....@.....@..
......@@...........@
.................@..
.@.@....@@..........
.............@....@.
............@.....@@
....@@..............
................@...
...........@.....@..
........@...........
........@.@@........
.@.....@.........@@.
.@..................
....................
.....@.............@
...@..@.............
