20,20
...................@
........@......@..@.
...............@....
..@....@@....@@.....
.......@.@@.@.......
....................
..........@....@....
..@..............@..
...............@....
..@.................
.............@....@.
...........@...@@...
@................@..
......@.........@...
.@.@........@.......
....................
...............@....
..@..@....@@........
.....@..............
.....@...........@..
