20,20
.............@......
....@.@.............
@.....@...@.........
......@......@.....@
....................
...........@@.@.....
..@....@............
...................@
@..@................
.@...@..............
...@.@...........@..
....@...............
...@...............@
...................@
.........@.@....@...
....................
.....@...........@..
@@@.............@..@
.................@..
..@@...............@
