20,20
...............@....
.......@............
......@.....@.....@.
......@@............
...............@....
.......@..........@.
.@......@.@..@......
..@.........@.......
..........@..@......
............@.......
...................@
.............@......
..@....@.@.@@.......
....................
..@......@..........
....@...............
......@.....@.......
@....@@@..........@.
......@......@@@....
....................
