20,20
........@...........
@.....@...@..@......
.@..@....@....@.....
....@..@@.....@.....
.....@..............
.....@..............
.@....@@........@@..
....@......@........
..@........@........
...........@........
...........@........
..........@..@....@.
....................
....@...............
....................
.@.@.....@....@.@...
....................
....................
@.........@.........
.......@.@...@......
