20,20
....................
.@@.....@....@......
....@.@.............
..........@.@...@...
...@...@.....@.....@
...........@...@....
......@...........@@
..............@.....
.@@@............@...
.@.@................
........@.@.........
......@.............
....................
...@@...............
....................
...@@...............
.@.....@........@...
.@...........@......
...@.@..............
.......@............
