20,20
.........@..........
.......@....@@@.....
.......@............
..@..............@..
........@.@.........
....................
..@.................
@@........@..@......
....@@..............
@.........@@.....@@.
@...............@.@.
.........@....@.....
...@................
.......@...@........
.........@...@.....@
.........@..........
............@.......
@@..................
..@...............@.
.............@......
