20,20
.............@......
.......@...@...@.@..
.........@..........
...........@........
...............@....
..@...............@.
..................@@
...................@
@.................@.
....................
.@.@................
...@.@.@............
@...................
.@.........@@.....@.
....@...............
........@...........
....@...............
.............@......
.@@@...@@@.@........
..@.......@...@....@
