20,20
..@.....@...........
...@.@.....@........
@................@@.
.@.....@....@.......
...................@
............@..@....
................@...
...@.......@.@......
.......@..@.........
..........@..@......
................@.@.
..........@@........
.@.....@.......@....
....................
...............@....
@........@@........@
.........@.@....@...
...................@
.........@@.........
....................
