20,20
.......@@....@......
@..@..............@.
....................
...@.@..............
....................
...............@@...
.....@..............
@....@..........@.@.
.........@...@......
......@@@...........
.@.@...@............
...........@@...@...
....................
....................
.@....@...@....@....
....@@......@.......
......@....@........
.....@.....@.@......
.....@.............@
....................
