20,20
..@.................
........@....@....@.
....................
....@...............
....@.@@..@...@.....
....@.....@.........
........@...........
@.............@....@
...............@....
...@................
.....@.............@
....@@..@.@.........
........@.........@.
...................@
..@.................
............@.......
................@...
..........@..@...@..
.@.@.@....@.@.......
@.....@.............
