20,20
.......@........@...
....@..@.......@@...
....@...............
.......@....@.@.....
................@...
...@....@......@..@.
.....@..............
....@.@.............
..@..............@..
.............@.....@
.............@.....@
..................@.
.............@...@..
@.........@.@.......
....................
@...........@.......
...@............@...
.@......@.........@.
..@.................
.......@..........@.
