20,20
@.........@.........
.........@.....@....
@...........@.@.@...
..............@.....
.@............@.....
.......@............
.....@..@........@..
..@.......@.@.@@....
...............@....
...................@
....@..........@....
......@..........@..
....................
...@......@@@.@.....
...@................
...............@....
......@.........@...
......@.............
.......@.@........@.
.......@............
