20,20
@.....@.@@..........
................@...
..@..@............@.
...@....@......@....
..............@@....
@...............@@..
...........@........
..................@.
....@@.@.......@....
....................
....................
..@.@..@...........@
.........@..........
@..@...@............
...@@.........@.....
....................
.........@..........
........@...........
..@..............@..
.@...........@....@.
