20,20
...................@
.............@......
.......@.......@....
....@...............
.......@....@.......
.............@......
.@@@................
.....@.@.@..........
@.@...............@@
....@....@..@.......
@.....@........@....
..................@.
...@.....@..........
.......@............
....................
...@..@..@..........
...@..@.............
...@..@.............
.............@......
..@@@........@......
