20,20
......@........@....
...............@....
......@............@
................@...
@........@@.........
.@........@.@.@.....
....@@..............
.....@..............
............@...@...
.....@@.@...........
......@......@......
.@..................
........@..@......@.
................@.@.
...@..............@@
..........@.........
........@..@.....@@.
..@.................
@..................@
....................
