20,20
....@...............
..........@.........
....@.......@...@...
.....@........@.....
............@@......
....................
.........@...@......
.@........@...@.....
.............@.@....
............@..@....
...................@
..@........@........
.....@......@....@..
...@....@..........@
.........@....@.....
.@........@.@.......
@...@..............@
....................
@...@........@.....@
@...................
