20,20
...............@.@..
....................
...........@...@....
..@..@..............
....@.....@.........
....................
....@..@............
......@.......@@....
.......@.........@..
....@........@......
..........@.........
.....@..@.@.........
..@..@...@....@.....
.....@..............
...@......@@........
.......@.@..........
..................@.
@@...............@..
.@@@.............@..
..............@.....
