20,20
.........@..........
...@................
..@@................
.@...@..@...@...@...
......@..@........@@
...@........@......@
....................
.....@...@@.........
@.......@...........
....................
.@..................
@...................
...@.@@...@...@....@
.@..................
.........@....@@....
................@...
....................
.............@....@.
@................@..
............@@......
