20,20
.........@..........
.......@...........@
...@......@@........
....@...............
......@....@........
.@...........@....@.
@...@...............
........@.@...@.....
.@..................
...@...............@
....................
....................
.............@......
..@..@..............
........@........@..
@..@..@.@.@....@....
@.@...@.......@.....
...................@
...@........@....@..
..............@.....
