20,20
@.................@.
..@.....@...........
...@....@.....@.....
...@.............@..
................@...
..@.........@.....@.
...@......@.........
....................
..................@.
@.........@@.@......
.............@......
....................
.@..................
.....@.....@.......@
......@.............
@@.@.....@..@.....@.
.....@.......@.@....
..@................@
.......@......@.....
...................@
