20,20
@..........@........
.@...........@......
......@.........@...
.@.....@..@.........
..................@.
................@..@
....................
......@.......@.@...
............@@..@..@
@..............@....
...........@........
....................
....................
....................
..@.........@@.@..@@
........@..@........
................@...
.....@...........@@.
......@....@........
@..@@...........@...
