20,20
....@...@........@..
..............@.....
..........@...@...@.
@....@..............
.......@@...........
........@.....@.....
....................
....@......@........
...@@...............
..@..@.......@......
.............@......
....................
............@......@
.................@..
....................
......@.@.@........@
@....@.@@........@..
..@.......@.........
....@.@.............
.....@@......@......
