20,20
.@...@......@.......
..........@.........
....................
@...................
...@......@.........
......@.............
....@@..............
.@..@..@.@@.........
......@..@.......@.@
............@.@.....
@...@..............@
..@.......@.........
.................@..
....................
@...@.........@.....
.@........@..@......
....................
..........@...@.....
@...........@......@
..@.....@...........
