20,20
.@......@.......@.@.
............@..@....
..@.........@.......
.@@.@.....@........@
@.............@.....
........@@..........
.................@..
....................
@...........@@......
@...................
....@@...@@..@.@....
...............@....
...@@.............@.
....@@@@............
....................
....................
.@..........@.......
..@.............@...
....................
....................
