20,20
....................
.............@......
.......@.@.....@....
....................
..@.................
.....@@...@.........
.......@......@.....
....@...........@..@
....@...........@..@
...@..............@.
.@.....@..@.@..@....
........@.@.....@...
@...................
@..........@........
........@@..........
..@........@........
.@..@@..............
....................
..........@.........
@.................@@
