20,20
.........@..........
....................
@..........@......@.
.@..................
......@@............
....................
...@..@@.@.....@....
....@@.........@.@.@
....@....@..........
@.....@.............
....@......@........
....................
.@...@..............
.....@.....@........
@..@.....@....@.....
.....@.....@....@@..
........@...........
.........@..........
....................
.........@...@.@....
