20,20
.@..................
.@.@.....@..........
...@...@............
.....@..........@...
....@...........@@..
..@..............@..
..@@......@.@.@.....
..................@.
............@.......
................@...
................@...
.....@...@....@.....
..@@......@.........
@@......@...........
.................@..
....................
@.@@................
..........@.........
.......@...@.......@
......@.............
