20,20
........@.......@...
......@.............
.................@..
@@......@.........@.
...@.....@..........
......@.............
..@..........@......
....@............@.@
....................
......@...@.....@@..
.............@..@...
..@......@..........
.......@.@..........
....................
.................@..
.@.@................
..............@...@.
.......@....@.@.....
.......@...@..@.....
.....@...@..@.......
