20,20
.............@....@.
@..@............@...
........@.......@...
..........@....@..@.
....................
..........@.....@...
......@..........@..
@.....@.@...........
........@...........
.............@......
.....@@.....@.......
.............@...@..
.......@............
.................@@.
........@.........@.
...........@........
@...................
..@.@....@..........
@.....@....@@.......
....@@..............
