20,20
......@...@..@......
@.@........@..@...@.
..........@.........
...@....@...@..@..@.
.......@.@..........
.....@..............
..............@....@
..............@.....
...@..@.....@.......
...........@........
@.........@.....@...
....@..@............
....................
...................@
....................
....@.........@.....
...........@..@...@.
.....@............@.
@............@...@..
....................
