20,20
.........@.@........
..............@....@
....................
..............@.@...
.........@..........
.................@..
................@...
.............@..@...
.@............@.@...
@....@.....@..@.....
@@..................
...@........@.@.....
.......@...@@.....@.
.@...@.............@
....................
...@@.............@.
.@.....@............
....@..........@@...
....................
.............@..@...
