20,20
......@.@@....@.....
....................
.........@..........
................@...
........@@..@...@...
..@.................
.......@............
@..@................
......@.............
........@......@....
....@...@@....@..@@.
....................
................@.@.
@@..@...............
....................
.............@......
..@....@.@........@.
..@.................
........@@..@.@..@..
.......@............
