20,20
.....@...........@..
.........@..........
....................
.....@..............
.........@....@.@...
....................
@...@...@...........
...@...@............
@...@...............
..@.................
@.....@.............
@................@..
...........@.@...@..
......@@............
..........@..@.....@
.@.@.......@..@.....
................@@..
........@.@.@@......
....................
...@@..........@....
