20,20
.......@.@.....@....
...........@........
.@....@.@.....@.....
.@...........@......
.....@.@............
...................@
.........@....@.....
....................
.................@..
..............@.....
.@.@................
...........@........
.@.........@.@.....@
............@@...@..
@.............@.....
.........@.@........
.................@..
@.......@.........@.
....................
@...@........@...@@.
