20,20
....@.@@@........@..
..@........@........
.@.......@..@.....@.
....................
@..@....@@@.........
..@..........@......
........@......@@...
...............@....
...@................
.................@..
..........@.....@...
.........@.@........
....................
...........@........
....@...............
......@...........@.
.@...@.......@......
...........@..@.....
.............@..@...
..................@.
