20,20
............@.......
.@.....@@...@....@@.
....@...............
...........@@.......
..@.................
....................
..@...........@.....
...@....@..@......@.
...................@
....................
.............@......
...............@.@@.
..........@.@.......
.......@@@..@.......
..@.......@...@.....
..@...@......@.....@
..@.........@.......
...@............@...
...@................
....................
