20,20
..@.......@.....@...
......@..@......@...
.............@@@...@
...@....@.@@........
........@.........@.
...............@....
.....@..............
....................
....................
..................@.
..@.................
.......@............
.@............@.....
...@.....@.......@..
....................
............@.@....@
......@@......@...@.
....@..@............
..@.....@......@....
..@......@..........
