20,20
........@.......@...
.@.........@..@.....
....................
.....@...@.......@..
@.........@@..@.....
........@...........
@......@...@........
.........@..........
.............@....@.
.@..........@..@....
..........@.......@.
......@........@....
.........@.....@....
..@..........@......
...........@..@.....
............@.......
..@................@
.@..................
................@.@.
@...........@.......
