20,20
..................@.
..........@.........
.........@.......@..
..........@.......@.
...@.@..@.@.@.@.@.@@
@..@...........@@...
..........@.....@@@.
.....@..............
...@........@.....@.
.........@....@.....
....................
....@.......@.......
.@............@...@.
....................
....@..@...@........
....@...............
....................
................@...
....................
...............@....
