20,20
@.......@...........
...............@....
......@........@...@
@.....@...@...@.....
.............@@.....
....................
..........@.........
.....@....@.........
@......@............
.....@..............
@.................@.
....@...@.....@.....
........@....@....@.
....................
....................
@.@.................
..@..@..............
.@.@@...............
....@@.......@......
.@.....@.....@.....@
