20,20
...@.....@..@.....@.
......@.............
....................
........@@..@.......
@@@@....@@.......@..
.....@.....@........
...............@....
..@...........@.@...
....................
.....@..............
......@@............
@............@......
....................
.............@......
...@.......@........
....................
.@.....@............
.........@@...@.....
@......@.@......@...
...@..........@.....
