20,20
....................
.............@......
.........@..@@......
@...................
.........@..........
..............@.....
....@.....@....@..@@
..................@.
.....@.@..@@........
....................
.....@..............
....................
.....@..@..........@
...@@...@..........@
.......@@......@@...
.@..........@.......
.....@@.............
...@................
..........@........@
.@.......@.....@.@..
