20,20
.......@..@.@.......
...............@....
...@....@...@@.....@
........@...........
................@..@
.@..............@..@
....................
..................@.
.@..............@...
@...@@.@...@........
@.@.........@.......
....................
....................
.@.......@...@.@@...
.........@.@........
...........@........
....@.....@.......@.
..................@.
.................@..
.....@..............
