20,20
....@...............
..........@.........
...........@........
..@.....@...........
...@@..........@.@.@
..@.................
........@...........
.....@.....@........
........@.....@.....
.........@..@...@..@
....................
...@......@....@....
..@........@...@....
....................
............@@......
@..............@.@..
..@......@..@.......
........@..........@
.......@............
..@.......@@........
