20,20
..@..............@..
....@....@..........
.....@@.....@.@.....
....@..............@
....................
....................
.........@@.@.@.@...
...@...@...@@.......
..........@......@..
....@..@....@.......
.....@......@....@@.
......@.............
...@..@.....@.......
..@.@...............
....................
...................@
@..@................
.................@..
................@...
.@..................
