20,20
....................
.........@@.....@...
....@........@@...@@
...................@
......@@.......@....
.........@.....@..@.
...@...@.@..........
.......@......@...@.
@@..@........@....@@
......@@.....@......
....@...............
...............@....
@..............@....
.............@......
....................
....................
...........@........
@...........@..@....
..@.................
....................
