20,20
....@...@@..@...@...
.......@............
..@.....@......@.@..
...........@.....@..
...................@
.@..................
..@..@@.............
..................@.
.....@..........@...
.......@.........@..
....................
..................@.
...@................
.@..@@..............
.......@............
.............@......
..............@.....
..@@......@.........
@....@.........@....
...@..@...@.....@...
