20,20
..@.................
@.@..............@..
......@.............
.......@....@.......
..@........@........
....................
.........@........@.
..........@.....@..@
..@@@............@..
....@..........@....
@....@@.............
.....@.......@....@.
@................@..
.@..@............@..
...@.@.......@......
......@.............
...........@........
.@....@......@......
@...................
....................
