20,20
............@.......
....................
..........@.@.......
..@@................
............@...@...
....@........@.....@
.........@.@........
..@..@@@............
....................
..@.@.........@.....
....@@.........@....
.....@@..@..@@......
.......@............
....................
....................
....................
....@.........@...@.
.@........@..@......
...@.......@........
......@....@@.....@.
