20,20
.....@............@.
..........@@..@...@.
.@..................
....................
.@..................
......@....@@.....@.
.......@....@.......
........@.@.........
......@.....@.......
....................
.@..........@......@
.............@.....@
....................
@.@.................
...@.......@.....@..
......@.............
@...@............@.@
...@..........@..@.@
........@...........
.............@..@...
