20,20
.................@..
....................
.@.......@@.@.....@.
.....@....@..@...@..
...@................
...........@........
...............@..@.
....@.........@.....
....................
......@..@....@....@
..@............@....
.......@............
...@........@.......
.........@.........@
............@.@.....
.....@......@.......
.@@....@.........@..
.....@.....@........
....................
..........@@.....@..
