20,20
.........@..........
.........@.........@
...................@
....................
........@...........
................@...
....@......@.@......
..................@.
......@..@.@........
..@...............@.
...@@.@.....@.......
..@.................
.......@...@........
....................
..........@.........
@........@.....@..@.
........@..@..@.....
.....@..@.@......@..
......@..@..@......@
..........@......@..
