20,20
........@.........@@
..@.@...............
@.........@.....@.@.
@...................
@...................
........@...........
....................
.....@..............
....................
....................
..@..............@.@
...@.@.......@......
.................@..
.......@..@@........
......@.............
......@.............
...@............@@..
........@........@.@
......@...@...@..@..
..@.........@.@.@..@
