20,20
....................
..@@...........@....
..@.....@.@........@
..@..@..............
@.@...@.............
....@...@..........@
........@......@....
......@.............
...@.............@..
..........@.........
..................@.
...@.......@.....@..
...@..........@.....
....@...........@...
....................
.........@..@.......
......@........@....
..@@.....@..........
..........@.........
......@....@@.......
