20,20
......@.......@.....
@............@@.....
....@.........@.....
.....@..@...........
..@..@.....@........
.................@..
..@...@...@..@......
.....@@.............
.........@....@.....
.......@.@..........
@.......@......@....
.......@....@@......
..@.................
........@....@....@.
....................
.@..................
.@.............@@...
......@.....@.......
.@..................
....................
