20,20
...@@......@........
..........@.........
....................
....@..........@....
.@.@.............@..
....@..@........@...
......@.............
..........@....@....
...@.........@......
....@....@..........
....................
....@...@...........
................@...
...@@........@@.@...
@..@.....@.@.....@..
...........@....@@..
..........@.....@...
....................
...........@.......@
...@................
