20,20
.@.....@......@.....
.........@..........
..............@@...@
....................
...@............@@..
..@.@...............
....@.....@.........
....@.....@.........
..........@.........
.@.@..@@..@.....@...
........@..........@
.@....@..@.@........
.@......@...........
..........@........@
....................
...@................
...........@........
.....@..............
.....@..............
...@.............@@.
