20,20
................@...
@......@...@........
................@@@.
...@................
.........@.....@....
..................@@
.@..........@..@....
..........@.......@.
..........@.........
@.........@.........
....................
........@....@..@...
....................
@@................@.
@...................
...........@.@......
...@@.@........@....
..................@.
......@.....@.......
........@...@....@@.
