20,20
..............@..@@.
.....@...........@..
.@....@...@.........
............@....@..
.@....@.............
.....@@.............
....@..............@
.@..........@......@
........@.@..@......
.@.............@....
......@....@........
....................
...............@....
.@.........@........
..@..........@......
.....@..............
........@......@@...
..@................@
.@..........@.....@.
....................
