20,20
.@..................
.........@..........
....................
....@.@...@.........
@.......@...........
...@......@.@@.@....
..............@.....
@...@.....@....@....
....@........@.....@
.............@......
..................@.
.@..................
@...@............@..
...................@
...@..............@@
.....@......@..@....
..@.................
@............@......
...............@....
.........@@....@....
