20,20
...............@.@..
.@.....@.....@@.....
.@.@................
.....@@.....@.......
.....@...@...@....@.
...............@....
..@@................
.....@.....@........
.@@......@...@......
....................
....................
....................
.....@...@..........
...@.@.......@......
.........@..........
..............@.....
...........@........
......@.@...........
..@...@@.@..........
@..@................
