20,20
................@@..
..@.................
........@....@......
...@...@....@@....@.
..................@.
..........@.........
@....@.@........@...
...........@....@@..
............@.@.....
...@................
........@.@.........
..........@.........
...........@.......@
....@.@......@...@..
...................@
...@................
...........@........
........@...........
@............@......
.....@...@........@.
