20,20
...@................
....@...@.@.....@..@
...........@........
........@..@........
............@.......
...@...@.@.@..@.....
.@.@.@..............
.....@..............
.........@........@.
.......@....@.......
........@.@.........
....................
........@..@........
...........@........
.@.....@..@.......@.
...................@
....................
...................@
..........@.@....@..
...@......@...@.....
