20,20
.....@...@..........
....................
....@.......@......@
.....@..............
..@.....@...........
............@.....@.
...@...@............
.............@......
...@.........@@...@.
..@.@.............@.
..@...........@.....
................@...
....@......@........
...@.@.....@.@......
...@........@.......
....@.........@..@..
.@..................
.@..........@@......
..............@.....
...@................
