20,20
..@.........@......@
....@..@............
.....@..............
......@.....@.....@.
.....@.........@....
........@@..........
............@.......
....@.......@.......
........@...........
....................
........@..........@
....................
...........@.....@..
...@.......@@.......
@....@..@........@..
....@...........@...
..@.....@...........
@.@.....@......@..@.
@...................
........@@..........
