20,20
.@..................
...........@....@...
.......@...........@
....@...........@@..
........@....@.@@...
..@.............@...
..@........@..@.....
.................@..
.........@....@.....
................@.@.
....................
.@....@..........@..
@@..................
..@....@............
....................
............@.......
..............@.....
...@.......@.@...@.@
.............@......
..............@..@@.
