20,20
......@@..@...@.....
.....@.............@
.........@..........
......@@......@...@.
..@@.....@..........
.....@..............
........@......@...@
..@@.........@......
.........@.....@....
....................
......@.............
...................@
..............@..@.@
@........@..........
.........@@.@@......
....................
...................@
@...................
...@......@.........
........@.........@.
