20,20
.......@............
....................
...............@.@..
@.....@...@.........
...................@
@............@@.@..@
....@...........@...
................@...
.@................@.
.@............@.....
..........@.........
..@..@..@...........
..................@@
.............@....@.
.........@.....@....
......@..@........@@
.........@.......@..
.@..............@...
.......@.@..........
...............@....
