20,20
....................
@...@...............
......@...@...@.@...
@...........@@......
...@@............@..
@..@.....@.@........
.............@@.....
..................@.
....................
...@.........@..@...
@..@................
..@.................
....................
.........@..@...@...
..@.................
.......@...@@.......
.......@.@..........
.@.@................
...@......@.........
.........@....@.....
