20,20
@......@.....@......
..@.@@.@........@.@.
.....@.......@.@....
@.................@.
.........@....@@....
....................
................@...
..........@.........
.............@....@.
........@...@.......
.....@.......@......
.....@..@..........@
..............@.....
.................@..
......@.....@......@
.@.............@...@
....@...............
................@...
@...................
............@.......
