20,20
....................
...@...@..@.........
.....@.@.........@..
..@.................
..........@....@....
...............@...@
....................
.....@...........@..
..@..........@.....@
.......@............
..........@.........
..@.......@.........
....@.......@.......
.....@....@......@..
..@....@@.....@.....
..............@...@.
........@...........
...........@.@@..@..
..@............@....
.....@........@.....
