20,20
.@.....@@..@..@.....
..@.................
@...........@@....@.
...............@.@..
...........@.......@
@.....@.@........@..
............@.......
.....@@@..@...@.....
..@.................
@........@..........
.........@..........
...................@
..................@.
.....@..............
...@.........@..@...
.........@..........
@................@..
.......@............
....................
.@......@...........
