20,20
............@..@..@.
.........@..........
...............@..@.
................@..@
.............@......
....................
.....@@....@........
......@.............
...............@.@@.
......@@............
................@..@
......@....@........
.@.@.@..............
...@........@..@....
......@.@...........
@......@............
..........@.........
@.........@.....@..@
......@.......@.....
................@...
