20,20
..@.................
@....@.....@.@......
.@@.................
......@............@
.........@..@....@..
@...................
.........@......@@..
....................
...........@........
......@...@..@......
.......@.........@..
..@..........@......
...............@...@
....................
...@.@...@...@.@....
....................
.....@.......@....@.
.................@..
...@.......@........
.....@........@.@...
