20,20
@.........@...@.....
..@....@.@....@....@
............@......@
@.....@......@......
....................
........@..@....@...
........@...........
....@...............
.......@.....@......
....................
.@..@...............
@.....@.............
.........@..........
.@.@........@.....@.
..@............@....
.@.......@.......@..
....................
@...................
@......@@.....@.....
.........@..........
