20,20
........@...........
...................@
...@....@......@.@..
....................
@...................
..........@.........
...@...@............
....@......@........
..................@.
.@....@...@.....@...
.@..@.@....@@@@.....
...@.@..............
.......@............
..@............@..@.
......@...........@.
..............@.....
....@...............
...................@
@..@........@...@...
.................@..
