20,20
........@@....@.....
....................
..@@................
..........@.........
..................@.
....................
......@.....@...@@..
.@..................
....@.....@.........
....................
..............@@..@.
.@.@@@.....@........
@.....@.............
....................
..@@......@.@...@..@
....................
........@....@......
......@@...@........
.@@................@
....@...........@...
