20,20
............@.@@....
@........@.....@..@@
...@.@.....@........
.....@..............
@...................
...@.@@.............
........@..........@
....................
....@............@@.
...@...@@...........
.....@..............
..@.......@....@.@..
.................@..
....@....@..@@......
...............@...@
....................
....................
........@...........
........@.........@.
..@.................
