20,20
.@..................
...@.........@......
.@......@....@.@....
.............@...@@.
...........@.....@..
.........@........@.
.......@@.......@...
.@..................
@...@.@.............
..@....@.....@......
.....@..............
.@.............@....
.@..........@.......
....................
.........@..@.......
....................
.......@.......@...@
.........@@......@..
....@....@..........
....@...............
