20,20
.......@@..........@
....................
......@.........@...
....@..@............
................@.@.
........@....@.@@...
.@..................
@.@.................
..........@@...@.@..
........@..@........
...............@....
....................
........@.....@..@..
...@........@.......
....@...............
..@.....@...@.....@.
...............@....
.......@.@..@.......
....................
...........@....@@..
