20,20
.....@.......@....@@
.@...........@......
@.......@...........
.....@...@....@.....
....................
....................
...........@..@.....
....................
.........@.........@
....@....@..........
........@...........
....................
.....@........@.....
...................@
......@..@........@.
.....@...@...@..@...
@..@.......@........
.@....@...@.....@...
..@..@....@.......@.
@...................
