20,20
....@@........@....@
........@....@......
..@..............@.@
..................@.
..@.........@...@...
.............@..@...
....................
..............@.....
...........@...@@...
.......@@...........
.@.....@.@.........@
.................@..
....................
.......@.....@.@....
...@................
......@..........@..
...@.....@....@...@.
.......@...@........
....................
................@..@
