20,20
...@...@......@..@..
....@.........@.....
@@..............@...
........@.@.........
..@.@.....@.........
@...................
...........@...@..@.
........@...........
..............@.....
.......@....@@......
@...................
...............@....
..............@..@..
....................
....................
.....@.@............
..@.@....@..........
...@....@...........
....@.@....@.......@
....@....@..........
