20,20
..............@.....
..@............@...@
@@.............@....
.....@..............
.................@..
...@...@............
...@.@..@..@........
.........@..........
..............@.....
........@.....@.....
..........@..@..@...
.................@@.
@@.@@...............
@................@..
..@...@@.....@.....@
....................
......@.............
@...................
...@................
@@..................
