20,20
.@........@....@....
....................
....................
............@.@.....
...@..............@.
............@....@..
......@.@...........
..@@...@....@@......
........@.....@.....
@...................
.@............@.....
.@@@@.@.........@...
...........@.@@.....
....................
..............@..@.@
....@...............
......@....@........
@...................
.@.@..............@.
....................
