20,20
.......@....@.......
....................
...........@..@.....
.......@.........@.@
.....@.....@@@.....@
@.@.@...............
.....@..@@.@.......@
....................
......@............@
.................@..
........@......@.@..
............@......@
.......@.@..........
........@...........
................@...
....................
...................@
...............@@...
.@.............@.@..
.....@..@...........
