20,20
....@.....@.@....@..
....................
.......@......@..@..
....@.@..@..........
@......@.........@.@
@....@.....@........
........@@.....@...@
....................
...@..@.......@.....
..................@.
..................@@
.....@..............
.....@..@...........
...@.......@.@......
...........@......@.
........@...........
....................
..........@.........
..@............@....
........@...........
