20,20
....................
...@..........@...@.
..@.................
@..........@......@.
....................
......@@.........@..
..@.........@.......
...................@
....@@......@.......
......@............@
.........@.........@
..@.................
....@.......@@....@.
.@.........@........
............@..@...@
..@......@..........
....@..@.@....@.....
..........@.........
......@@............
.@..................
