20,20
...............@@...
..................@.
.....@..............
....................
....@.@...@.........
...@.....@........@.
@@......@.....@.....
.....@.@.@..........
..............@.@.@.
...........@........
........@........@@.
....@.@......@@.....
....................
....................
..@................@
..@@....@...........
.@..................
.........@..........
@...............@@.@
......@.............
