20,20
.....@....@.........
........@..........@
........@......@.@.@
.............@..@...
.@....@@............
....................
....@....@..........
..........@.........
......@...@.........
.......@@...........
.............@..@...
.@..@...............
............@..@..@.
......@......@......
...@@.............@.
...@@..@........@...
....................
.......@....@.......
.....@.......@......
....................
