20,20
..@...@...........@.
...............@....
......@.......@..@..
@@..................
.......@............
.............@...@..
.....@....@.....@...
..@...............@.
@...................
....................
....................
..........@..@......
.............@..@...
.........@..........
....@....@.....@..@.
..@.@............@..
....................
.@..............@...
..@...@........@..@.
......@......@.@..@.
