20,20
.....@..............
............@.......
......@.@.@.........
....@.@.............
....................
.......@.....@..@...
.@.........@..@.@...
...@................
................@...
....................
.........@.@..@.....
...............@.@..
...@@.....@.........
@.@.@...............
.@................@.
........@...@@@..@..
...............@....
.....@...........@..
............@....@..
..@.................
