20,20
......@..........@..
..........@....@....
........@@..........
.@.@...............@
..@..@@........@....
...@...@............
..................@.
.........@..@@......
.@..@...............
...@................
....................
....@...............
.....@..............
............@.......
..........@...@.....
..@..@.......@......
.@.....@.....@......
.@.......@@@...@....
...@.............@..
....................
