20,20
.@...@....@.....@..@
....................
..@......@.....@....
....................
........@...@.@@....
....................
......@..........@.@
.......@...........@
.@.@........@.......
...@................
...@.........@......
............@.......
.@.........@........
...........@..@.....
......@.............
.@.@...............@
...........@@.......
.....@.....@........
.@..........@.......
.......@.......@....
