20,20
..@.......@@.@......
....................
......@@........@...
........@...........
....@........@......
......@.............
..............@.....
.......@@........@..
.........@..........
...................@
.....@.....@...@....
........@@..........
.@@...@....@.@.@....
.................@..
............@.@.....
................@@..
......@...@.........
......@...@.@.......
........@........@..
....................
