20,20
........@@..........
...............@....
..@.................
......@..........@..
.@.......@........@.
.....@......@.......
.@.@..........@.....
...........@....@...
.@...............@..
........@...........
@.............@.....
....................
@..@..........@.....
......@...........@@
........@.......@...
.@............@.....
.......@......@.....
.@....@.............
....@.....@..@...@..
.....@..............
