20,20
..........@.....@..@
...@@..@.@......@...
..@@....@...........
@...................
..@.................
...................@
.......@...@........
.....@..............
.....@.....@........
..@.................
.@........@.@.......
..@.@...............
.....@......@.....@.
...........@.@...@..
..@..@........@.....
....................
@..@.@..............
......@.............
....................
...........@@.......
