20,20
..........@...@.....
...........@...@....
............@...@...
..@.................
......@........@@...
...........@........
....................
....@...@...........
...@..@...@..@......
.....@..............
.@.............@...@
.........@..........
.....@.....@........
..@@................
.......@.@..@..@@...
....................
...........@..@.....
......@..@..@.......
....@@..........@...
.................@..
