20,20
......@......@......
...@................
.............@..@...
..........@.........
...........@........
.@.@.@.....@........
....@..@@.........@.
.......@.@..........
..............@.....
............@....@.@
...............@....
.................@..
....................
......@...@.@.......
.....@..............
......@.............
..............@.....
@.......@......@..@.
.......@@.........@@
................@.@@
