20,20
............@@......
.......@@...........
..@.........@@......
....................
..........@.........
.....@............@.
...@..............@.
....@...............
.................@..
.....@...@.@.@@...@.
.@.........@........
.......@............
.......@@.......@...
............@.@..@..
..................@.
..@@................
........@@..@.......
................@...
...@.....@..........
...........@..@.....
