20,20
.......@.........@..
......@......@......
......@...@.........
....................
..@........@........
..........@.........
.@@.@........@......
..........@.@.......
.............@......
.@...@@...@.........
....................
......@.....@....@@@
............@.......
....................
...@..........@.@..@
....@..@.........@@@
....................
.......@@@..........
@..@................
....................
