20,20
....................
......@............@
.............@.@....
.@......@.....@.....
.@@@...@......@..@..
.@@.................
....................
.@......@...........
.......@.......@..@.
.@..................
...@...............@
...........@....@...
....................
........@...........
.............@...@..
..........@..@.@..@.
...@.......@......@.
..................@.
....................
.....@..@.@..@......
