20,20
..........@.@...@@..
.....@...@....@..@..
........@..@........
..@..@.............@
...............@....
.........@........@.
....................
....................
@..@................
....................
.......@............
@...................
....@...........@..@
......@......@......
.@..@........@......
.....@.....@.......@
.@....@.........@...
..@.................
....@.@......@......
.....@..........@...
