20,20
...@....@.......@.@.
..@.................
...@................
..........@.......@.
............@.......
@...................
...@......@....@....
..............@.....
......@............@
@@................@.
....................
.@.....@........@...
..............@.....
.........@.....@..@.
...@.......@......@.
..............@.....
...............@....
...........@....@...
....@.@...@.........
..@@....@..........@
