20,20
............@....@@.
....................
....................
...@...........@..@.
....@...@...........
..@..@....@.........
.@.......@..........
....................
...........@.......@
..@...........@@....
......@.........@@..
@..............@....
............@.......
......@...@.........
....................
..@.@...............
@....@.....@@.......
..................@.
@........@........@.
....@......@@.@.....
