20,20
.........@@.........
..@.........@@.@....
..@..@..............
......@.............
@.......@...........
...............@...@
..@........@.......@
....................
@............@@.....
...........@..@.@.@.
....................
....................
..@....@.@.......@..
...............@....
....@........@@.....
..@.................
..................@@
....................
....@.....@.........
.......@.@......@..@
