20,20
@.........@.........
...@...........@....
.............@......
................@...
.....@.....@.....@..
...............@....
@....@.@.@.........@
..@.........@......@
.................@..
.......@..........@.
........@@.........@
.@.................@
@.@.............@...
..................@.
.......@..@...@...@@
....@.......@.......
......@........@....
....................
....................
................@...
