20,20
....................
..@.@...............
@...@..@@...........
....................
@.......@.....@@..@.
............@.......
..@....@....@.......
....................
......@.............
....................
...........@........
.@.......@..........
..@...@....@....@...
.....@..............
................@...
.........@.......@..
.......@.@..@....@..
......@.....@...@...
..@.....@...........
...@@...........@..@
