20,20
.......@@....@......
.............@...@.@
....................
..................@.
@.........@..@......
....@...............
...................@
@...................
........@...........
@....@....@.........
....@@.@............
..@.................
...........@.......@
@.........@...@@....
....................
............@......@
............@...@...
.....@....@.........
@...........@....@.@
.........@.......@.@
