20,20
@.................@.
...@..........@.....
....................
.....@..@.......@...
..@............@....
......@......@..@...
................@.@.
....@..........@..@.
........@........@..
....@.......@@.....@
....................
....................
.......@...@....@.@.
..........@...@.....
.................@..
..........@......@..
.....@..@......@....
......@..........@@.
...............@....
.....@..............
