20,20
...@.....@..@.......
.................@.@
....................
@...................
....................
...............@....
...@@..............@
..@........@@.......
.....@..........@...
.@..............@...
......@.@@...@.....@
...........@.....@..
@.@................@
.@......@.....@.....
....................
......@........@..@.
..@.................
.........@........@.
...............@@...
............@......@
