20,20
...............@..@.
....................
.....@.....@.....@..
....................
.............@..@@..
..............@....@
......@.....@......@
@............@......
........@...........
............@.......
..................@.
@.....@@@...........
.......@......@@....
.....@........@.....
......@.@@..........
....................
...@...............@
....................
....@.@..@..........
..@.@..@........@@..
