20,20
@...@...............
....................
....................
..........@.........
.@..............@@@.
....................
@..@................
..@....@........@@@.
.....@.@...........@
...@........@@..@...
.@...@.......@.@....
..........@.........
...@.....@..........
....................
........@...........
.@........@.....@...
......@.............
........@.@...@..@@.
.......@............
@...................
