20,20
...............@....
@...................
.@................@.
............@.......
........@...........
.........@........@.
.....@..............
....................
.@...@......@.......
......@..@..@.......
...@..@....@.@......
....................
.@@..@..............
.....@@..@......@...
...@.....@.........@
....................
....@......@........
.@...............@.@
..@....@..........@@
............@...@...
