20,20
.........@@........@
...................@
.@..............@...
@...........@...@...
..@.................
....@...............
..@..............@..
................@...
...@............@...
.......@.....@......
.@.........@........
.......@............
....................
.@.@@............@@.
....@.@.............
@.....@...@......@..
@....@.....@.....@..
.....@............@.
.......@............
.......@............
