20,20
..........@......@..
.@..................
...........@..@..@..
.....@............@.
....................
..............@.....
....@...............
...............@@...
...@@...........@..@
................@...
..................@.
........@@.......@..
............@@@.....
.........@....@...@@
..@..@.@@@..........
............@.......
................@...
....................
........@@..........
.@........@..@......
