20,20
..@.............@...
.....@@.@..@........
..@@.........@.@....
.@...........@@@....
.@....@@@.......@...
....@...............
....................
....................
....................
....................
....@...............
.............@......
........@......@.@..
..@..@.....@.....@@.
....................
............@.......
......@......@.@.@..
@......@............
.............@.@....
...................@
