20,20
..................@.
......@......@..@...
@............@......
....................
..@................@
....................
...............@....
......@..@..........
.........@..........
.........@..........
.................@..
........@@......@@@.
....................
............@.......
...@................
...........@...@....
.@.................@
.@...@.......@.@.@..
@@..@@.....@@....@..
@..@...........@....
