20,20
..@..........@......
..@.....@...........
....................
.....@.@............
..........@...@..@..
@..............@....
....@.........@@..@.
@...@......@........
...@.@..............
.........@..........
@.....@.@...........
..@.................
.....@.@....@.......
...........@..@.....
.......@.........@..
..................@.
......@.@.........@.
...................@
.......@............
.@................@.
