20,20
............@.......
......@.@..@.......@
@...@...............
.....@...@....@.....
...@..@..@..@@..@...
.@@.......@.......@.
.......@............
.@..................
@...............@...
..............@.....
............@.......
...@...@............
....................
...@................
@..@...........@.@..
...........@........
...................@
.@....@.......@.....
......@.............
..............@.....
