20,20
..............@.....
.........@..@.......
...@................
...........@.@@....@
....................
............@.......
.....@..............
...............@....
.@..@@..............
............@......@
............@@......
......@.............
.....@@.....@..@....
@........@.......@..
....@...............
.@....@..@..@....@..
.........@....@.....
.............@.....@
.@......@.@.........
@...................
