20,20
.@.........@....@...
.@.............@....
.......@...@........
...........@........
@@.....@@@.......@..
..........@.........
....@.......@.......
........@.....@.....
..........@.@.......
....................
.......@@.....@.@...
@.....@....@....@...
........@....@...@..
.....@............@.
.............@......
.......@....@.......
...............@....
....................
............@.......
...................@
