20,20
........@........@..
.........@..........
.@...@........@.....
......@...@..@.@....
.............@..@...
...@..........@.....
........@........@.@
........@......@....
....................
..........@.........
...................@
....@@......@.......
....................
........@...........
..............@@..@.
......@@.@..........
..................@.
...@................
.@...@..@...........
..@...@........@@...
