20,20
@....@......@.......
....................
..@.............@..@
...............@....
.....@..@..@...@....
..@.@@...@.........@
........@.@..@.@@...
.......@............
..........@....@....
@.....@..@..........
...........@........
....................
..@.................
.@..@............@.@
..@.................
..........@@........
....................
..@.................
@...@...............
@...................
