20,20
..@.@...........@...
..@........@......@.
....................
.....@.........@....
....................
.@........@........@
.................@..
..@@................
...@.@........@.....
....@...............
@.........@.@.......
............@.......
............@.......
......@@..@@.@......
......@.......@....@
.............@....@.
......@.............
....................
@...........@.@.@...
............@......@
