20,20
....................
..........@......@..
.@.........@..@.....
.......@............
.@....@.@.@.........
......@........@.@..
..@.......@.........
........@.@.......@.
.....@...........@.@
.....@........@.....
....................
..@..........@.@....
....................
........@..@@..@@..@
..@..............@..
..................@.
...................@
...............@@..@
....................
......@.............
