20,20
......@@.......@....
...@................
........@...........
..............@@....
...@...@@...........
@.@.........@@......
.@......@@....@..@..
....@...........@...
..@..........@.....@
....................
.@..............@@..
..................@.
........@.@.........
.............@......
....................
.............@.....@
..@........@...@....
.@...@....@.........
....................
............@.......
