20,20
....@...........@.@@
......@...@.@.......
..@@@......@.....@..
....@.....@.........
...........@.@......
....................
........@...........
@.@.......@.........
.............@......
................@...
....................
..@.................
.........@.........@
@........@..........
.................@.@
...@.........@@.....
....@......@.......@
....................
...@.......@...@...@
............@.......
