20,20
........@.......@...
....................
............@.......
..@..@..............
.........@......@...
@...................
..@..@............@.
.......@............
@...................
..@........@......@.
.@.........@.@......
..........@.........
.......@.......@....
...........@.@.....@
...@........@.....@.
............@...@...
..................@.
.@@......@..........
.@......@.@.........
.@@..@..............
