20,20
.............@......
...@..@..@....@.....
.@...............@..
....................
......@.........@...
...........@........
....@...............
..........@@...@....
...@...........@....
....@...........@...
......@....@........
.........@..........
.....@..............
.@...@........@@@...
....................
.@.....@...@........
....................
....................
...@@.....@......@@.
....@@......@@.....@
