20,20
.........@..........
.............@......
..............@.....
.@.@.............@..
...@........@.......
.....@..............
...............@.@..
.@...@@........@....
.@..@..@@@..........
..@........@.....@..
...........@........
....................
.........@.....@....
.......@.........@..
.............@......
.................@@.
..............@....@
.@..@....@..@.......
..................@.
....@............@..
