20,20
....@.....@...@.....
.@...@.............@
...@................
..@........@.@....@.
.@.......@.@........
..@...........@.....
......@..........@..
...............@....
......@.....@.......
....................
.......@.@..........
.......@...@........
.............@.....@
....@@....@.........
.....@.@............
....@........@......
@.@.............@...
....................
....................
.............@..@@..
