20,20
........@........@..
..........@....@.@..
....................
......@..@..........
....................
...........@......@.
....@.......@.@.....
.............@@...@.
.......@@..@..@.....
.....@....@.........
.@..................
@..........@........
........@...........
..@.................
@.@......@.....@.@..
...............@....
....................
...@...........@@...
......@.......@.@...
...........@.@......
