20,20
........@...........
..........@......@@.
......@...........@.
...@......@......@@.
.............@......
.....@.........@.@.@
.............@....@.
....................
.....@.@............
...........@.@......
....................
@......@.......@....
...@.............@..
.......@...@........
....................
.@@........@........
@...................
.@...............@..
................@...
...@..@...@..@...@..
