20,20
.......@......@.....
@........@..@.......
...@.@.........@....
.......@........@..@
.........@........@.
.....@...@..........
...............@....
.............@......
.@.....@............
.......@.....@@..@@.
@...........@...@.@.
...@................
.........@..........
..................@.
..................@.
@.@@................
.@..........@.......
................@...
...............@....
......@.............
