20,20
.................@..
..........@..@...@..
....@.....@.........
.@.......@@........@
.....@...@..@.......
.@..................
...@.......@@.@.....
....................
@..............@....
..@.................
....................
....................
@.........@..@......
@@..................
.@..................
............@@..@.@.
....................
..@........@.......@
............@@......
.@@.@......@........
