20,20
...........@...@....
..............@....@
....................
.....@..............
..@.................
......@............@
.........@..........
...@...............@
...@......@..@.@...@
..............@.@...
................@.@.
........@...........
...@................
.......@............
..............@...@.
....@.@...........@.
............@.....@.
....@...@.@.@.@.....
...........@...@....
....@.....@...@.....
