20,20
........@.......@...
............@.......
.....@..............
@........@..........
....................
....@.......@....@@.
........@...@.......
..@...@........@....
@.......@....@@..@..
...@.............@..
@@.......@........@.
........@......@....
.@..................
...............@....
....................
....................
@@.....@.@.@..@..@..
....................
...................@
....@.........@.....
