20,20
...@...@............
....................
.......@.......@@.@.
.........@..........
@...................
......@....@...@@...
.@..............@.@.
....................
....................
.......@.@..........
......@..........@..
............@....@..
............@.....@.
.......@.....@......
.@.......@.........@
................@...
........@.@@...@....
...@...@............
............@..@....
.....@....@.......@.
