20,20
....................
.........@.......@.@
.....@..........@...
............@......@
......@.............
@...@.......@.@@....
..........@....@....
.@.....@............
@.@....@............
..@..@........@@....
..................@.
...............@....
.......@............
............@.@.....
.@...........@@....@
...@................
....................
............@....@..
....@@...........@..
...@................
