20,20
....@..@.....@.....@
.@...............@..
....@...............
..........@.........
@.......@...........
...........@.@......
.@............@@....
..................@.
....@..............@
..............@.....
...........@@.......
....................
.................@..
.........@....@.....
@.....@.@.......@...
@...@.@.....@.......
......@.............
.@......@.....@.....
....................
....@@.@..........@.
