20,20
.....@.@........@..@
.....@.....@.@.@....
.......@.@..........
..................@@
....................
....................
...........@@.......
....................
....................
...@..@..@.@@......@
.@.........@........
........@@..........
.......@..@.........
.@.....@............
....................
...@...@...........@
........@........@..
...........@@.......
......@...@..@.....@
.........@..........
