20,20
..@.........@..@....
@.......@.......@...
@........@..........
..............@..@@.
........@........@..
................@...
....................
...............@....
.......@........@...
...................@
..............@..@.@
............@.@.....
...........@.@@.....
......@....@....@.@.
..@.................
@.............@.....
...................@
.@..................
@....@............@.
...........@......@.
