20,20
.....@@..@......@..@
.@@.................
........@..@..@.....
...@.@.@...@........
@@@.................
....................
......@....@...@...@
....................
..@............@....
@........@......@..@
....................
..............@.....
.........@..@.......
.............@......
..........@......@..
...@.....@...@......
....................
...................@
.............@......
.....@...@..........
