20,20
........@.......@..@
.................@..
@...........@.......
..@.................
.........@.@........
..@..@.....@..@.....
.................@.@
...@................
.....@@....@@...@...
................@.@.
......@............@
..........@.........
.........@@.........
....................
....................
....................
.....@.......@@.@.@.
.......@@....@.@....
....................
..........@@.....@..
