20,20
..@..........@......
............@.......
.........@....@..@.@
@..............@..@.
....................
....................
...........@@...@..@
....................
...@..@.............
........@......@....
..........@.........
............@.......
@.............@.....
..@@..@..@..........
...............@....
......@....@........
....................
@.....@...@.@.......
..@........@.....@..
....@.@.....@@......
