20,20
.........@..........
....@.......@.......
.@..................
......@....@...@...@
...............@....
.......@.....@.@....
..@...........@.....
......@....@...@....
........@.@.........
.........@..........
....................
..............@@....
.@.............@@...
......@.......@.....
@...@@..@...........
.@........@.........
.................@..
...............@...@
..................@@
.....@......@.......
