20,20
........@....@......
..........@......@@.
.....@........@.....
.............@......
.........@....@.....
....................
.........@.....@....
.......@..@....@....
................@...
.............@..@...
....@.@.........@...
..@....@......@....@
@.........@.........
@..................@
.....@@.......@.....
.@...@.@............
...............@....
....@..@............
....@..@............
....................
