20,20
....................
..............@.....
..@........@........
............@.@.@...
...................@
.......@...@@.......
@..............@....
@.@..........@......
.........@.........@
.....@...@.........@
.........@.......@..
...................@
..........@.@.@@..@.
....................
....................
...........@....@@..
@.........@..@...@..
............@.......
...........@.......@
...@..@.............
