20,20
....................
..................@.
..@..@.....@........
......@........@....
........@@..........
................@..@
..............@....@
.......@.......@@@..
............@.......
@..........@........
@..@...........@....
.................@..
...@........@.......
...@....@..@........
...@@...............
......@..@.......@..
...@................
.............@......
.@......@......@....
.........@@.........
