20,20
...........@.@......
....................
......@......@......
................@.@.
....@...............
...@................
...............@....
.@.@................
.@..................
.......@@....@......
......@.@........@@.
....@......@....@...
.......@............
....................
..................@@
........@.....@.....
...@.....@@.@@@.@...
@................@..
......@.....@....@..
..................@.
