20,20
.......@..@..@.....@
....@.....@.........
....................
............@@...@..
.........@@...@@....
....................
..............@.....
..@.................
..............@...@.
..@.....@...........
.@....@@............
....................
...........@@.......
....@............@..
....@.....@.........
..........@...@.....
....................
.@.........@..@....@
.@@...........@....@
....@......@........
