20,20
......@..@.........@
@.@..........@@....@
.@@...........@.....
.....@...@..........
..@.................
...@@...............
....................
....................
.@..........@.....@.
..@...@.............
....@.......@.......
..@.@.@.............
......@.............
...............@.@..
....................
......@.............
@.@.................
@.........@.@.@.....
......@.............
........@.......@@..
