20,20
.@..@...............
..@........@......@.
..........@...@..@.@
@...................
....................
.@@................@
.......@@...........
....................
....................
@.......@...........
............@@.....@
.@..................
....@..@...@........
........@...........
.....@..@...@.......
...@................
@...@@......@..@....
....@...............
...........@......@@
@.............@.....
