20,20
.........@.........@
.........@..@@......
....................
....@@...........@..
......@.@..........@
........@....@......
..................@.
...@................
...@@.@........@....
....@...............
....@.@.............
....................
...@.........@@.@...
.....@......@.......
@..@....@....@..@...
....................
.@.................@
....................
......@....@........
..............@@..@.
