20,20
.......@.....@..@..@
............@.@..@..
...................@
.@....@....@........
...@..........@.....
....................
.....@..............
...................@
.........@....@.....
.......@......@.....
..@.@.....@.........
.....@............@.
..........@.........
.........@.....@.@..
..@........@@.......
....................
@........@@@........
..@.................
...............@....
....@......@..@.....
