20,20
.....@......@.......
.............@......
@....@..............
....@...............
..@....@@....@...@..
.......@.......@....
...............@....
.@.............@....
......@........@.@..
.@@.................
....@.....@.....@.@@
....................
......@...@........@
......@.............
...............@.@.@
...........@.@...@..
...................@
...........@........
..@.............@...
....................
