20,20
........@...@.....@.
.....@......@.......
................@...
........@@....@....@
.................@..
....................
....................
...............@....
@...........@......@
......@...@......@@.
@......@............
..........@.........
@.........@.........
................@...
...................@
@.........@.........
....@@@......@......
........@..@...@...@
.................@.@
...@.......@........
