20,20
.@..............@...
...............@...@
@.@..............@..
.....@..@...........
........@...........
....................
..@...........@.....
....................
..@....@....@.@..@@.
....@...............
....................
.............@......
......@........@....
@...@......@.....@@.
..............@.....
..........@.......@.
.......@............
@..@................
...@..@.@...@......@
.......@...@........
