20,20
.......@.........@..
.@.@@..@.......@....
..@.........@@.@....
....................
....................
....@...............
........@.@...@....@
................@...
..@.................
....@..@.@..........
................@...
.........@....@.....
..............@.....
@.....@.............
...@@......@........
.@................@.
.....@...@..........
.....@..@@..........
..@.........@.......
..........@.........
