20,20
......@........@.@..
......@............@
.................@@@
....................
.@.........@...@....
...................@
...@.@..@.....@.....
.............@......
@....@..............
...@....@@..........
.........@@........@
@...................
....................
..@........@........
.................@..
...@..........@.....
.........@......@...
@...........@.......
.........@.......@..
..@.@.............@.
