20,20
.................@..
@....@....@.........
...@......@.......@@
..............@.....
....................
......@.............
..........@......@.@
....@..........@...@
@..@............@...
......@.@...........
........@.........@.
...........@........
..@.........@..@@...
...@@..............@
....@........@......
..........@.........
.@.....@............
@...................
...@................
...@.@..............
