20,20
@........@....@.@...
.............@......
...........@........
.@@.....@.........@.
@...........@...@...
......@..@@.........
..@...............@.
.................@..
..........@.........
......@.......@.....
....................
..........@@........
...@.@..............
...@.@....@..@......
..............@.....
.@..................
................@...
.....@@.@...........
.....@.....@......@.
.....@..............
