20,20
..@...@.............
....@..@....@@.@....
........@...........
...@.@.........@....
...@................
.......@............
....................
....@....@.........@
......@....@....@...
.@........@.......@.
......@.............
....................
...@................
.......@.@.......@..
.@...@.@............
....@...............
.....@...@..........
....@...@......@@...
........@...@.......
......@.............
