20,20
....................
......@..........@..
........@....@.....@
.....@..............
..@..@.......@..@...
..........@.....@...
...............@....
.....@........@.....
.@..............@...
...................@
.@...@@.............
....................
.......@............
.......@.@.@........
..................@.
........@.....@..@.@
.@....@@.........@.@
...............@....
..@...........@.....
...@......@.........
