20,20
..@.....@...@.......
....................
....@@..............
......@.............
.........@..@..@...@
.............@......
.....@...@..@.@.....
.@...............@..
.......@............
.........@@....@..@.
.....@..............
....@...@.....@.....
..@.................
........@..@......@.
.......@............
..........@.........
.........@..........
.........@...@......
.............@.@.@..
......@..........@..
