20,20
........@..........@
......@@..@.........
....................
...........@...@....
...................@
....@......@.@......
....................
@............@......
..@.....@..........@
..........@.........
@...@.@@............
.....@..@...@...@...
......@......@......
...........@........
....@...............
...................@
....@...............
.....@..@...........
....@..@....@.......
........@.@.@....@..
