20,20
..............@....@
............@....@..
................@.@.
.....@..@..........@
@...@.....@.........
.....@.....@....@...
....................
..@...@.......@.....
.............@....@.
............@.......
.................@..
@..................@
@...@.@...........@.
....@............@..
.....@...........@..
..@.@...............
............@....@..
...............@....
......@.@...........
.........@..........
