20,20
......@......@......
....................
........@..@........
...@@..........@....
@.@.......@.........
....................
....................
.....@...@..........
@@...@........@.....
@......@@...........
.@.....@...........@
..........@..@..@...
..............@.....
@..............@....
...........@........
......@........@....
@.........@...@.....
..@...........@.....
...@....@...@@......
....................
