20,20
..........@.....@...
......@...@.........
....................
@@......@...........
...................@
..@........@........
@@..........@.....@@
......@....@..@.....
....@.@..@..@.......
@...........@.@...@.
...............@....
...............@....
.........@..........
....................
@...................
.................@..
....@...@.........@.
.......@...@....@...
.........@..........
...@......@.........
