20,20
.......@....@.@.....
...@@...............
......@....@.@....@.
.......@............
............@.......
..............@.....
......@...........@.
.............@....@.
.@.@................
....................
.....@........@....@
....@@.....@........
@..@.@..............
@...............@...
..............@.....
....................
.@....@...@.........
....@.........@.....
@..........@.@.....@
......@.............
