20,20
.....@.............@
..@....@..@.@.....@.
....@......@........
..............@.....
.@..................
....................
.....@..............
.@.@................
.....@..............
.............@...@..
....................
...............@....
.........@...@.@..@@
.....@...@....@.@...
................@...
@.......@..@..@.....
..........@.......@.
.........@.@.....@@.
....................
...@.............@..
