20,20
...@................
.....@...@...@...@..
@.............@.....
.@............@.....
....................
..@.....@@....@.....
.....@....@....@@@..
.............@......
...@..........@...@.
....@.............@.
......@......@...@..
....@..@............
@.....@..@....@.....
...................@
....................
........@...........
@...................
@.........@......@..
.@..................
....................
