20,20
.@..............@...
......@.........@...
...........@..@.....
...@@.........@.....
....@@..............
....................
.........@..........
......@..@...@.@....
....@....@.....@....
...@....@...........
....@...........@...
......@.@...........
@..@.........@......
......@..@..........
...@................
....@..........@....
..@....@............
.@..................
..........@.........
..@.......@@........
