20,20
................@..@
.................@..
....@...............
..........@.........
@.@.................
@.@.................
...@@............@..
...........@........
.@..................
@..@.@..............
.......@@....@..@.@.
@.........@.@..@@...
..........@.........
@........@.@........
....................
@..............@....
.................@..
.@...@..............
.........@..........
...@......@........@
