20,20
@......@.......@....
..@@.........@......
.@.@......@.........
@..................@
@.....@.....@.......
.@..................
..@......@..........
.......@............
@...................
.@.@...@.......@....
........@...........
@@...............@..
....@@..............
..........@@......@.
....................
....................
.@......@...........
.........@@.........
..@@................
.................@@.
