20,20
.....@.@@...........
@..........@@.......
.....@..@....@......
.....@..............
...........@........
.@...@..............
@...................
.@...........@......
..........@.........
.............@...@..
...........@........
.................@..
..@.....@...@....@.@
.@..................
........@...........
.....@..............
@.....@...@.......@@
...........@........
.......@...@........
....@.......@....@..
