20,20
............@.......
....................
..................@.
..@........@..@.....
.........@.@...@....
..@..@.......@.@....
..@.................
.@.................@
..@.............@...
....@....@..........
...............@...@
.........@..@.......
@..........@........
..@......@..........
..@.......@.........
................@...
..........@..@......
..@........@..@.....
....@....@@.........
.......@.....@......
