20,20
.......@......@..@..
@..@.....@.....@.@..
....................
..............@@..@.
..............@.....
@..........@........
.@..@......@.....@@.
......@...@......@..
....................
..@@..........@@....
......@.............
...............@...@
.......@............
.......@.....@......
............@@......
...............@....
....................
...@................
..@...@.............
.........@...@......
