20,20
....................
...@..........@...@.
................@.@.
@.............@.@...
...@................
@................@..
@...................
............@......@
...@..............@.
.............@......
..@@.......@........
@@.................@
...@.............@.@
......@......@......
.......@......@.....
......@....@@.......
......@@.....@......
....................
..........@.........
...@.@..........@...
