20,20
..................@.
@......@............
...........@..@.....
.@@....@@...........
......@@.@..........
.......@.......@.@..
....................
............@....@.@
.......@............
......@...@.........
............@.......
.........@..@.@.....
.@..@....@..........
..@....@...@........
...@........@@..@...
........@@......@...
...........@........
....................
....................
..............@.....
