20,20
..@...............@.
@...................
....................
.........@....@@....
@.....@.@.....@.....
...@.@..............
@................@..
.....@...@...@......
...........@@....@@.
.@..................
.@..@.............@.
..........@.........
@@..........@.......
....@.............@.
....................
...................@
................@..@
....................
.........@...@......
...@.......@.@.@....
