20,20
@..@@......@.....@..
.........@@.@...@...
..@............@....
............@.......
.............@....@.
..........@........@
...........@........
.....@........@.....
.........@..........
.@..................
......@.............
.@.....@............
@..@..........@...@.
....@.@.............
.....@......@.......
@@........@......@..
.......@.........@..
.......@............
...........@........
....................
