20,20
.........@..........
.......@............
...........@...@....
.......@.@........@.
.........@..........
.@...@.......@.@.@..
...@...@.@.......@..
......@.............
@..............@...@
......@@..@.........
...............@....
....................
....@......@........
.......@..........@.
............@.......
@..@...@............
....@.........@.@...
.........@.........@
...@...............@
....................
