20,20
............@.......
....................
......@...........@.
..@.................
..@.......@.@.@@....
...@................
..@..@....@......@..
....................
.........@..........
..@....@............
........@...........
.@........@.........
@.@.........@..@..@.
.........@@......@..
.@..@...@.......@...
..@.................
.....@..............
....@@..............
.......@.....@.....@
...........@........
