20,20
.....@..............
.@......@....@...@..
.........@........@.
...............@.@..
.@.....@.....@......
...@......@.........
............@.@.....
........@.@..@......
....................
...................@
........@.........@.
..@..@.....@........
.................@..
......@.............
....@.....@.........
.....@....@...@.@...
.............@......
..@....@.......@....
....@....@.@........
....................
