20,20
...@....@.@......@..
.......@............
.@.............@....
.@...@.............@
.......@............
......@..@......@...
....@...............
...@......@.......@.
...................@
.......@@....@...@@.
.....@.....@........
....................
..........@.........
.................@..
.....@..@..@........
...@...........@....
.......@......@.....
........@...........
.....@@@@...........
....................
