20,20
@.....@..........@..
.........@..........
............@@......
@.....@.............
.@............@.....
....................
.................@..
.@.@.@......@..@....
....................
........@....@....@.
...............@.@..
..............@.....
.........@..........
.@@..@....@.@.......
..@.................
...@.@...........@..
..@.................
@@.........@........
@....@.........@....
...........@........
