20,20
...................@
.....@....@.........
....@...............
.....@.........@....
................@..@
......@.............
............@.@.....
....@@....@.@....@..
.@..................
....................
.@....@.@...........
.........@........@.
..........@@.....@..
....................
........@@@.........
....@..@.....@......
..@...@.............
........@.........@.
.@@.................
...........@.@...@..
