20,20
@.........@.........
..........@.......@.
............@...@...
.........@..........
..................@.
.......@....@...@...
...........@........
....@.@.......@.....
..@.............@...
@...................
..........@....@....
.......@............
.....@..@......@....
......@.............
@.@.........@...@...
...................@
...........@...@....
.......@....@.@.....
....@..@............
......@..@......@...
