20,20
@.............@....@
............@.......
........@..........@
.......@.......@....
....@..@........@...
@........@.@@.......
....................
....@.....@@...@....
...................@
....................
.....@..............
....@......@@...@...
........@...........
@.....@.@...........
@..........@........
......@...@.........
............@..@....
.........@..........
.@....@..@..........
...................@
