20,20
.....@..............
..@............@@..@
..@............@....
....................
....................
........@.@.......@.
....................
....................
@.............@.....
....................
.......@..........@.
....................
@.....@......@......
........@@....@.@...
......@...@....@@@..
..@....@......@.....
...@.@....@.........
.........@.....@@...
.......@....@.......
@.....@............@
