20,20
.............@.....@
....................
...@............@...
@..............@....
..@.................
....@.............@.
.@.@.......@........
........@....@.@....
....................
...............@....
...@..........@.....
..@.................
...@.......@...@@...
..@...@...@...@..@.@
....................
@........@..........
.@....@@............
....@........@..@...
....................
....@@..........@...
