20,20
....................
..@........@........
...................@
@...........@.......
.@..............@@..
.@.....@..@.....@...
....@.@@............
@..........@........
..@.......@.....@...
.............@......
@..........@........
..@........@........
..@........@........
..............@..@..
...........@........
....@...............
.....@@.@...........
..........@@........
....................
..@..@@.........@...
