20,20
................@...
...................@
..@.@............@@.
@...................
.....@.........@..@@
..................@@
....................
....................
@...................
..@..@.....@....@..@
....................
.....@.@............
......@.@......@....
...........@..@.....
..........@.........
...........@...@....
......@@@....@......
..@..........@......
.......@.@.......@..
............@......@
