20,20
....@...........@.@@
...@................
........@........@..
.@..................
.@.......@....@.@@..
............@.......
...................@
.......@@...........
.@.....@......@.....
..........@.........
.....@@..@..........
.....@..............
..........@........@
........@...@.......
....@...............
........@.........@.
@@..............@...
@......@............
..@....@............
..............@.....
