20,20
@.............@@@...
.......@@....@.@....
............@.......
@.............@.....
........@........@..
..............@.....
....................
.@.....@...........@
..............@.....
.............@..@...
....................
@............@......
..@.@...............
.....@@@..........@.
...........@......@.
.....@.@....@.......
@............@......
.......@............
...@.......@@.......
....@...............
