20,20
.@..................
.....@..........@...
....................
......@.............
.@...@.........@@...
...............@....
............@.......
....@......@.@.....@
...........@........
..........@........@
.................@..
@...@...@......@....
..@........@...@....
....................
...@@......@...@....
..............@.....
.@.@.........@.@....
@..@...@...@.....@..
....................
@...................
