20,20
...@................
.........@..........
....@...............
.@........@.........
.................@..
....................
.................@..
....................
.@@......@..........
....@............@..
.....@....@.........
...@....@...........
..@...@.............
.@.........@...@@..@
@............@...@..
........@..@@..@..@.
.............@...@.@
.............@......
...@................
.........@@......@@.
