20,20
@@..........@.......
......@.......@.....
.@.........@...@...@
................@...
.............@......
...............@....
............@.......
......@..@...@......
@....@...@..........
@.....@....@.......@
....................
............@@@...@.
....................
...@..@...@.........
....................
..........@.........
..@........@........
........@......@....
.......@@..........@
@............@......
