20,20
@...@........@......
@...............@...
......@........@....
....................
..............@.....
......@........@.@@.
............@.......
..................@.
..............@@....
............@@.@....
....@..........@..@@
...@..@....@....@...
@..@............@...
..@.@...............
.........@.........@
.........@...@....@.
@.....@......@......
....................
....................
....................
