20,20
............@.......
...@..@.......@.....
@.@...@.............
........@.@@........
....@..@............
.........@..........
@@...........@...@..
......@........@@...
...@........@.......
.......@..........@.
..............@..@..
...@............@@.@
.....@@.............
.....@@........@....
...........@..@.....
......@.............
....................
....................
....................
...@...@............
