20,20
@...................
....@.........@...@.
....@.@.............
@....@..............
....@.......@.@...@.
..........@.........
..........@...@.....
.........@..........
....................
..........@.........
...@.............@@.
....................
.......@@..@........
.@......@...........
@@.@..........@.....
...@...@............
........@..@@.......
....@@@.............
.............@......
.......@......@.....
