20,20
...@@...@......@@...
..............@.....
....................
..................@.
.....@.@.@..........
@..@.........@......
......@.............
.@..................
.......@.@..........
...............@.@@.
...............@....
..............@...@.
..........@.........
.........@.....@....
....@.........@@....
...........@.....@..
@..............@....
....@..@...@......@@
............@...@...
....................
