20,20
....................
...........@@.......
....................
@...@.............@.
....@....@.@..@.@...
.......@...@@.......
....................
...@................
@.@@...........@@...
...@.............@..
....@.@...........@.
....@...............
............@@......
..................@.
.....@......@...@...
..@.@.........@..@.@
.........@..........
@...................
...................@
..............@.....
