20,20
....................
..........@...@.....
................@.@.
...@...@............
.@.@..........@.....
.........@..........
.....@........@.....
.@.............@....
...@................
.....@@...@.........
@.........@.........
..@...@.......@.....
...@......@.@..@@@.@
@...................
................@...
@..............@....
....................
.............@......
@...@..@.........@..
.....@..............
