20,20
........@@..........
...@......@..@......
......@.....@.......
....................
..@..@.......@....@.
....@.....@.........
..............@.....
........@....@...@..
....................
............@.......
...............@.@..
...............@....
.@....@..@@....@....
....................
......@...@@........
....................
..@........@....@...
......@@..@..@.....@
...............@.@..
............@.......
