20,20
....@..@............
.......@...........@
....................
.......@.........@.@
...@.......@.......@
..@.....@...@.......
........@.@..@...@..
....................
......@.............
.......@............
.@..................
..............@.@...
..........@........@
.@..................
..@......@.@....@...
@...................
.......@....@.....@.
.....@.........@....
........@..@@....@..
.@..................
