20,20
.......@............
........@.........@@
......@.......@.@...
..............@....@
............@.......
..@.@...........@...
....................
....@.@@............
...............@...@
.................@@.
..@....@........@...
.............@......
........@.......@...
@..................@
......@...........@.
.........@..........
.....@........@.....
.....@.......@......
............@.@...@.
...@...@............
