20,20
@...................
...@....@...........
................@...
....@..@.@..........
..@.@...............
....@...............
....................
.....@..............
....................
........@.@.........
..........@..@......
.......@...@.@......
....................
.....@..............
...@.@....@@.......@
.........@......@...
...@.....@...@@.....
.@.........@@.......
@..@...@.....@......
.....@....@.....@...
