20,20
....................
....................
.......@...@........
....................
..@.@..@.@..@.......
..@.........@.......
......@........@..@.
.........@.....@....
....@............@..
.......@..@.........
.....@.....@........
..@@........@.......
....@...........@...
.......@@......@....
....@......@@.......
..................@.
............@.......
..@...@...........@.
@.........@@........
................@...
