20,20
....................
@@...............@..
..@........@........
..@@...@............
..@...@....@........
.................@..
@..@................
@.................@.
.@...@...........@..
........@.....@.@...
......@.............
....................
.@@...@...@...@@....
........@......@.@..
.....@...@..@.......
....................
.@................@.
.............@.@..@.
....................
....................
