20,20
.........@.@.@......
...........@......@.
.....@.@............
..@@..@........@....
..............@@....
.......@..@.........
@.......@.........@.
.......@......@.....
@...................
..........@@........
...@................
....@..............@
...................@
...........@........
@.........@..@......
......@.@.....@.....
......@....@........
......@.............
.....@..........@...
......@.............
