20,20
....@......@........
.......@......@...@.
.......@............
....................
@.....@.....@.......
....................
.........@.@.@@.....
...............@....
....................
.......@.@@......@@.
.......@....@.....@.
...@..@.............
....................
@@.....@............
.......@...........@
.@..........@.......
..........@.@.....@.
.................@..
..@...@.........@..@
.............@......
