20,20
...........@........
@...@...@...@......@
......@...........@.
.....@..............
...............@....
....................
...@@...............
..@.................
..@..........@.@..@.
....................
...................@
........@.........@@
.........@..........
...@.@...........@..
....@.@...@.@.......
...........@....@...
.........@.@........
...@...@............
...@...........@....
@......@..........@.
