20,20
@@.......@.@....@.@@
............@...@.@.
..@..@@........@....
@.......@...........
..@..........@......
...............@....
.........@.....@...@
.......@............
....@...............
..@......@..........
....................
..........@........@
.@............@...@.
....................
..........@.....@...
...................@
.....@.............@
.......@.@..........
........@.....@.....
....................
