20,20
........@...........
........@.@.........
....................
............@..@....
.@.........@........
.........@.....@....
..@..........@......
.....@..............
@..@....@.@.........
..@.................
....................
.........@..@....@..
...............@....
......@.@.@...@.....
...@...........@....
..@@.........@...@..
......@..@..........
...@...@....@.......
.........@..........
@...@.....@.........
