20,20
.....@.@@.....@.....
.@.............@....
......@........@....
@.@....@.....@......
..........@.@.......
........@...........
....................
.......@...@@......@
..................@.
....................
....@..........@@...
........@.......@...
....................
...@................
........@.@.........
.......@.......@...@
..........@.....@...
....................
..@.......@...@....@
.@...@@.............
