20,20
....................
....................
............@...@...
....@...@....@......
....@.....@...@.....
................@...
..........@..@..@...
................@@..
..@...........@.....
.........@.........@
.@..................
......@........@....
...@..............@.
.@..................
......@.......@@....
..@....@............
...@@.@.....@.......
...................@
.....@........@.@...
..@.....@.........@.
