20,20
......@@............
.@..........@.......
.......@............
.@.........@........
@..@.@.......@......
@....@.@......@.@@.@
.......@............
.@..@...@...........
@..................@
..............@.@@..
................@...
.@..................
....................
.................@..
............@.......
@............@@.....
..........@..@.....@
....@...............
....................
..........@......@..
