20,20
@...................
...@....@.@.......@.
......@...@.@.......
........@....@......
.....@@.......@.....
@...@.......@.@.....
.........@.@....@...
.........@.........@
.......@...@........
@...................
........@...........
...........@....@...
..@.................
..............@.....
.......@...@........
.......@............
....@...............
............@.......
...@........@.......
.....@.........@...@
