20,20
..@@@.@@..@....@@...
..@.....@.....@.....
....@@...@.@@..@..@@
@.@.....@.@....@....
@.@@...@@.@....@..@@
...@...@@.@.........
.@@...@.@.....@.....
....@@@.@@.....@...@
@.....@........@@@..
...@....@.@@..@....@
.......@@..@.@@.....
.@@...@.....@..@.@..
..@.........@..@@.@.
.@@.@..@.@..........
........@@.....@..@@
.@.@.@..@..@..@.....
@.@...@.@@......@@..
......@@@@.@@..@@..@
@@@.@....@@@@...@...
............@.@@....
