20,20
@@@@..........@@@..@
@@@..@@@.@@@@...@@.@
@@@.@@@..@@@@@@....@
@@@..@@@@@@@@@@.@.@@
@@@@.@@@@@@@@@@@..@@
@.@@.@@@...@@@@@.@@@
@..@.....@.@@....@@@
@@.@.@@@@@.@@@@@@@@@
@@...@@@@@.@@@@@@@@@
..@@@@@@@@.@@@@@@@@@
@..@@@@@@..@@@@@@@@@
@@.@@@@@@@.@@@@@@@@@
@@.@@@.....@@@@@.@@@
@@.....@.@@@@@@...@@
@@@.@@@..@@@@...@..@
@...@@..@@@@@.@@@@.@
..@@@@.@@@@@@.@@@@@@
.@@@@@......@.@...@@
..@@@@@@@@@.....@@@@
@@@@@@@@@@@@@@@@@@@@
