20,20
@@@@@@.@@@@@@@...@@@
@@@@@@.@@@@@@@@@.@@@
@@@@@@.@@@@@.@@@.@@@
@@.@...@@....@@@...@
@@...@@@@.@@@@@@.@@@
...@@@@@@.@@@@...@@@
.@@@@@@@@......@@@@@
.....@@@..@@.@@@@@@@
@@@@.....@@@.......@
@@@@.@@@@@@@@.@@@@.@
@@@@.@@@@@@@..@@@@.@
@@@@...@@@@@@.@@@@.@
@.@@@@...@@@@.@@@@.@
@.@@@..@@@@....@@@.@
@.....@@@@..@@..@@.@
@.@@@.@@...@@@@@@@.@
..@@@.@@.@@@@@@@@@.@
.@@@@.@@..@@@@@@@@..
.@@@@@@@@@@@@@@.@@@.
@@@@@@@@@@@@@@@.....
