20,20
....@......@...@....
@.@.@........@@.....
@........@..@..@...@
.........@....@.....
.......@...@.@@@@...
..@...@...@.@.@@@...
..@...@@..@.@...@..@
..@.@.@@@@....@....@
@...@@........@@@@..
.@@..@@..@@..@...@@@
.........@@@@..@@...
@.@.@@.........@....
....@@......@..@....
@@.@@@..@...@......@
@....@@@@..@..@@@.@.
........@.@.@.@.....
@@......@......@....
....@@..@.....@@.@.@
.@...@...@@...@...@@
....@@@.....@.@.....
