20,20
@.@@.@@@@.@@@@@...@@
........@.@@@@@@@...
.@@@@@.@@........@@.
.@@@@@@@..@@@@.@.@..
.@@@@.@@.@..@..@...@
....@.@....@@.@..@..
@..@@....@@@@@@@@@@.
@@.@@.@@.@@@@@@@@@..
.@....@@.@.....@@@.@
.@.@@@@@...@@@@@@@.@
.@.@.@...@..@@@.@@.@
.@.@.@@@@@@.@@@.@@.@
.@.@.@@@@....@@.@..@
.@.@......@@.@..@.@@
...@@@@@@@.....@@..@
.@...@@@@@.@@@@@@@.@
.@@@@@...@..@@@@...@
...@@@.@...@@@@@.@..
.@.@@...@@@@@@@@.@@.
@@.@..@.@@@@.....@@.
