20,20
.....@@.@.@@....@...
@@@.@@..@..@.@@.....
.@@..@........@...@@
..@..@........@@...@
....@@@@.@@.@@...@..
@.@@..@...@..@@.@.@.
..@..@...@....@...@.
@...@.@@@......@.@.@
@@@.@.....@..@.@.@.@
......@@......@.....
@..@.@@...@....@@...
.@.@.@.@@....@...@..
.@..@@..@..@..@@@..@
..@@.@@.@.@...@@@...
..........@...@.@@..
@.....@...@.....@@@@
...@@.@.@...@.@...@@
.@@@.@...@.@@..@....
..@@....@..@.@..@...
...@..@.@.@.....@.@.
