20,20
......@.............
....................
....@...............
.@..................
.@..................
.............@......
....................
.....@........@...@.
....@............@..
....................
..........@.........
@.............@.....
...............@....
..@...............@.
@...................
@...................
....................
....@...............
....................
...@................
