20,20
..........@@.....@..
....@...............
.@.....@@@....@.....
....@...............
.@.@..@...@.....@...
....@...............
...........@@.......
...............@.@..
..................@.
...@................
..@@.........@......
.................@..
..............@.....
....................
.@...@@...........@@
....@...@...........
.....@........@.@...
...................@
.......@............
................@...
