20,20
......@.@.....@..@..
....................
.@......@..@........
...............@..@@
.@.......@..........
.....@.....@.....@..
@.................@.
...@..@.....@.......
.................@..
....................
.....@.@............
.@..........@...@.@.
.....@.............@
............@.......
....................
.@..................
..............@.....
........@....@......
@....@...@@...@.....
.............@......
