20,20
@@@@@@@@@@...@@@@@@@
@@@@@@@@@@.@@@@@@.@@
@@@......@.@@@@@@.@@
@@@.@@@@.@.@@@@@@..@
@@@.@@@@...@@@@@@@.@
@@..@@@@@@.@@@@@@@.@
@@@@@@@@...@@@@@@@.@
@@@@@@@@.@..@@...@.@
@@@@@@...@@.@@@@.@.@
@@@.@@.@.@@@@@@....@
@@.....@@@@@@@@@@@.@
@@.@.@@@@@...@@@@@.@
@..@.@@@@@.@.@@....@
@.@@.@@@@@@@..@.@@.@
@.@@.@.@@@@@@.@.@@.@
@.@@...@@@@@@.@.@@.@
@.@@@@.@@@@@..@@@@.@
@...@@...@@@@......@
@.@@@@@@...@..@@@@@@
@...@@@@@@...@@@@@@@
