20,20
@@@@@@...@@.@@@@..@@
@@...@@@.@..@@...@@@
...@.....@.@@@.@@@@.
@.@@@@.@.@.@@@.@@...
...@@@.@........@.@@
@@.@@@@@@@@@.@@...@@
@@@@@@@@@....@@@....
@@@@@@@...@@@@@@@..@
@..@@@.@@...@.@@@@..
@.@@@..@..@...@@@@.@
@.@@..@..@@.@@@@@@.@
@....@@.@@...@@@...@
@@.@....@@@@@@@@.@.@
...@@@@@@@@@@@@@@@.@
.@..@@@@@.@@@.@@@@.@
.@@...@@@..@@.@@@..@
.@@@@.@@@@....@....@
.@.@@@@@@@@.@...@@..
....@@@@@@@.@.@@@@@.
@@@....@....@@@@@@@@
