20,20
@@@.....@@@@@@@@.@@@
@@..@@@.@@@@@....@@@
@@@@@@@....@...@..@@
@@@@@@@.@@...@@@@.@.
@.......@..@@@@.....
..@.@.@@@.@@@@@@.@@@
@@@@@@@@@.@@@@@@@@@@
@@.@@@....@@@@@@@@@@
@@...@.@@.@..@...@@@
@@@.@@.@@.@@...@.@@.
@@@.@@.@@..@.@.@.@..
..@.@@@@@@...@@@@@.@
.@@..@@@@@.@@@..@@.@
......@@@@..........
@@@@....@@@@@@.@.@@@
@@@@.@@..@..@@@..@@@
@....@@@.@@.@@@@...@
@@.@@@@@..@.@@@@.@@@
@...@.@@@....@.@.@@@
@@@...@@..@@.......@
