20,20
@@@@@@@@@@@@@@@@..@@
@...@.........@@.@@@
@@@..@@@.@@@@.@@...@
@@@....@....@@..@..@
@.@.@@.@.@@....@@@..
@.@.@@.@..@.@@...@@.
..@.@@.@@..@...@..@.
.@@.@@.@@.@..@..@@..
....@@.@..@@.@@@@..@
.@@@@@...@@@..@@..@@
.@@@@@@.@@@@@.@@.@@@
@@..@@@.@@@@..@@..@@
@@......@..@.@@@.@@@
@@@@@@.@@@.......@@@
@...@@.@...@..@.@...
@@@....@..@@@@@...@@
@@@@@.@@.@@@@@.@@...
......@@@@@@@@....@.
.@@@..@@@@.@...@.@@.
.@@@@...@@...@@@@@..
