20,20
.@@@@.@..@@.@@....@@
.@@@@.@@....@@.@@@@@
......@@@@@.@@.@@.@.
@@.@.@@@@@@....@....
@..@.@@@....@@...@.@
..@@@@..@.@@@..@.@.@
@...@......@@@@.@@.@
@.....@.@@.@@@@..@@@
@.@.@@@...@@@..@..@@
@@@..@@.@@@...@@@.@@
@@@@@@@...........@@
@.....@@..@@@.@@@@..
@.@@@.@@@...@......@
@.@@@@....@.@@@@..@@
@.......@@@@@@@@.@@@
@@@.@@@@...@@....@@@
@...@@@@.@.@@.@@...@
@@.@@@...@@@@.@@@@.@
@@...@@.@@@@@.....@@
@@.@......@@@@.@@@@@
