20,20
@@@@@...@.....@.@@.@
@.......@@@.....@@.@
..@@...@.@@..@.@.@..
@.@......@@....@...@
@..@..@..@@......@@.
..@..@@@@..@.@......
@@@.....@.....@@..@@
.@@@...@@..@.@@.@...
...@..@...@..@..@...
.....@...@..@.@.....
..@...@.@.....@..@.@
.@...@.@..@.@.@@@...
.....@........@...@.
@..@..@@..@....@..@@
..@@@......@@...@...
..@.@...@..@@.@...@.
....@.@.@@.@@@....@.
..@.@@@@.......@@.@@
@.@....@...@.@@....@
..@...@@.@.@.@...@..
