20,20
......@@.@@@.@.....@
@.@@@....@@..@.@.@.@
...@@@..@@@@...@.@@@
.@.@@@@....@@@@@..@@
.@@@@...@.@@@@@@@...
@@@....@@.@@.@....@.
@@..@..@@@@@...@@@@.
...@....@@...@@@....
@.@@.@.@...@...@@...
..@@.@@@@@.@@.@@..@.
.@@@....@...@@@@.@..
.@.@@.@.@.@@@@@@@..@
@...@@@...@...@.@.@@
@.@.@@....@@@.@....@
@.@....@@.@@...@@@.@
@.@@.@@...@@.@..@@..
@.@..@@.@....@@.@..@
...@.@...@.@.@@.@@@@
.@.@.@@@@@..@@....@@
@@.@@......@@..@@@@@
