20,20
...@..@.....@@@..@.@
@....@@..@.@@......@
.@..@@..@@@.@..@.@..
..@....@.@@...@...@@
...@...@.@@.@...@...
.@.@.....@@.@.......
.@.@..@.....@@@.@.@.
@......@.@@@.....@@@
..@..@.@....@.@.....
@.....@@@....@.@.@@.
.@.......@.....@@@@.
..@@............@..@
..@@..@@.@.@@@@....@
@..@.@@.@......@.@.@
.@..@@..@...@.@.@..@
.....@@.@....@......
..@@@@@..@......@@@.
@......@..@@..@@@...
..@.@@@@......@.....
@@@......@.@..@..@@.
