20,20
.@.@@.....@.........
.@........@@@..@.@@.
...@@.@.@..@@..@.@@.
@..@@@..@@@@@@@..@@.
.@@@.@@..@@.@@@.@@@.
.....@@.@...@@@.@@@@
.@@@....@@..@@@....@
..@@@.@..@@.@.@@@@..
.@...@.@.@@...@@@.@.
..@@.......@.@.@@...
@@@...@.@@@..@..@@.@
@.@..@....@.@@@.@...
....@@@...........@.
..@@@@@...@..@.@.@..
....@@@@..@@@@@@..@.
@@.@@..@@..@@@.@@.@@
.....@...@..@@.@..@.
.@@...@@.@@..@..@...
..@@......@@@.....@@
@@@..@@....@@.@@@.@@
