20,20
@@@@@@@@@@@....@@@@@
@...........@@.@@@@.
@.@@@.@.@@@@@@..@@@.
@.@@@@@.@@@@@@@.@@..
..@@@@...@@@@@....@.
@@@@...@..@@@@.@@...
@@@..@..@@@@...@.@@@
@@@.@@@.@@@@.@@@.@@@
@@@.@@@.@@@...@@.@@@
@@@.@@@@@@@@@....@@@
.@@.@@@@@@@@..@@.@@@
.@@.@@.@...@@@@@...@
.@@.@@.@.@.@@@...@.@
.......@.@@@@@@@@@.@
@.@@@@...@@...@@@@.@
@.@@@@@@....@@@@.@.@
@..@@@@@..@@.@@@.@.@
@@.@@@@@@.@@.@...@.@
@@.@@@@@@.@@...@...@
@@.@@@@@@@@@@@@@@@@@
