20,20
....................
.....@........@.....
.....@..............
....................
...@................
.............@......
.....@.....@........
....................
....................
.........@..........
....................
....................
.@..................
...@...@............
....................
@..@.....@..........
...@................
..@.................
...@.@......@.......
.....@..............
