20,20
..........@.@...@...
.@@..@...@....@.....
..@.........@.......
@@................@.
....@.....@...@..@..
....................
@@.@..@......@.@....
..@.@...@.......@@..
.....@....@..@....@.
..@@.......@......@@
...........@..@@....
.......@@.@.......@.
......@.@.....@.@@..
@.@@@........@......
@@@.........@..@....
.@.......@@@@@.@@@..
.@....@@.....@.@....
.@..@.........@.@...
...................@
@.@.................
