20,20
@.........@@@@@@@@@@
@@.@.@.@.@@.@@.@...@
....@@@@@@.......@.@
@@.@.@@@...@@@.@@@.@
@........@.@@@.@@@..
..@@.@@@@@@@@@.@@@@@
.@@@..@...@@......@@
..@@@@@@@..@@@@@..@@
@.@@...@@@..@@@@@@@@
@.@@.@....@.@@@@@@..
@.@..@@@@.....@@@@.@
...@.@@@.@@.@@@@@@..
@@.@.@@...@.@....@@.
.....@..@.....@@....
.@@@.@@@..@@@@@@@@@@
...@.@@@.@@.@@@.@@@.
.@@@..@.....@@@.....
.@@@@.@@@.@@@@@@@@.@
.@@.@...@.@@@@@@@@.@
@@....@@@..........@
