20,20
@@@@.@@@@@@....@@@@@
@@...@..@@@.@@....@@
@@.@@@@.....@@@@@@@@
...@@@@@@@.@@@@@@.@@
@@.@@.@@@@.@@@..@.@@
@@....@@@@...@.@@...
@@.@@...@@.@.@.@@@@.
@@.@@@@.@..@@@.@@@@.
@@.....@@.@@@.......
.@.@@@.@......@@@@@@
.@.@@....@@.@@...@@@
.....@@@@@@.@@@@.@@@
.@@@.@@@@@@.@@...@@@
@@@@.@@..@@....@...@
@@......@@.@@@@@.@.@
@@.@@@@@@...@@@@@@.@
@@.@...@@.@.....@@..
@....@.@..@@@@@.@@@.
..@@@@...@@@@@..@@..
.@@@@@@@.@@@@@.@@@.@
