20,20
@@@@@@@@@@@@@..@@@@@
..@@@@@@@@.@@.@@@@.@
.@@@@@@@@@....@@@@.@
...........@@@@@@@.@
.@@@.@@@@@..@@@....@
@@@@....@@@.@...@.@@
@@@@@@@.@@@...@@@.@@
@@@@@@@.@@@@@@@@@.@@
@@@@@@@.@@@@@@@@@.@@
@@@@@@@..@@@.@....@@
.@@@@@..@@@@...@@.@@
....@@.@@@@@@@@@@..@
@@@.@@....@@@@@@@@..
@@@.@@.@@.....@@@@@.
@@@..@.@@@.@@.@@@@@.
@@@@.@.@@@@@@.@@@@@.
@......@@@@@@..@@@@.
@.@@@@.@@@@@@.@@@@@@
@@@@...@@@@@@.@@@@@@
@@@..@...@@@..@@@@@@
