20,20
....@...@........@..
....@..............@
..............@....@
...........@........
.........@..........
.@......@........@.@
@..@................
....................
...............@....
......@....@........
..........@.........
..@.@......@.......@
....................
...@.............@..
....................
.....@@...........@.
@@.....@...@....@...
..@.....@...........
.@........@.........
....@.......@....@..
