20,20
.@@...@@@@@.@..@@...
..@.@@@..@@.@@...@@.
@....@@@.......@@.@.
@.@@....@@@@@@......
@.@@.@@.....@@.@.@.@
@.@..@@@@.@.@@@@..@@
@.@@.@@.@@@..@@@@.@@
@...@@@..@@@..@@@.@.
@@@.@.@@..@@..@@@...
..@...@@@.@@.@....@.
@..@@..@@......@@@@.
@@..@@.@@@@@@.@@@@@.
...@@...@@..@@...@@@
.@....@@@...@.@@.@@@
..@@..@@@.@....@.@@.
.@....@@.@...@.@.@@.
@@.@.......@.@.@.@@.
@@.@@@.@@.@@@.....@.
..@.@@.@..@@@.@@@.@.
@......@@...@.@@@...
