20,20
@...@@@@@@@@@....@@@
@.@.@@@@@@@@@@.@....
@.@.@@@@@.@@@@.@@@@.
@.@.......@@@@..@@..
@.@@@@@@@....@@.@@.@
@.@@@@@@@@@@....@@.@
@.@@@...@@@@@@@@...@
@.@@@@@...@@@@@@.@@@
@.@@@@@@@.@@.@@..@@@
@...@@@...@@..@.@@@@
@@@.@@@@@..@@.@....@
@@..@@@@@@.@@...@@.@
@@.@@@@....@@@.@@@@@
@...@@..@.@@...@@@@@
@.@.@@.@@@@@.@@@@..@
@.@.@@.@@@@@.@@@@@.@
@.@........@..@....@
@..@@@.@@@.@@...@@@@
@@@@@@.@@@.@@@@....@
@@@@@@@@@@.@@@@@@@@@
