20,20
@@@@.....@@.@@@@@@@@
@...@.@..@@.@@@.@@..
@@.@..@@@@@.....@..@
@....@@@.@..@@.@@.@@
@.@.@@...@.@@@....@@
@.@.@@.@@@.@...@.@@@
@@@....@@..@@@@@.@.@
@@..@.....@@@@@@...@
@@.@@@@@.@..@.@@.@@@
@@..@@@.....@.@.....
...@@...@...@.@.@@@.
@@@@@..@@.@.@.@..@@@
@.@@@.@@..@...@@.@.@
@.@@@@.@...@@@@@...@
.........@..@@@..@.@
@@.@@@@@.@@@@@@.@..@
@@.@.@@..@@@....@.@@
@@...@@.@@@@.@@@@.@@
...@.@@.@@@..@....@@
@@@@..@..@@.@@@.@...
