20,20
@..@....@@@@..@.@.@.
@.@..@@.@..@@...@...
@.@..@.@@..@@.......
@.......@...@.@..@.@
@.........@....@@..@
@.@@@@@@...@@...@...
@@..@@@.....@..@@...
@.......@@.@@.@@.@..
.............@.@.@..
@....@....@@.@...@@.
...@@@...@.........@
..@@..@.@...@..@@.@.
@@.......@.@@@@.....
....@@......@@@@....
@...@....@.@.....@@@
.@...@....@...@@@.@.
.@.@@@...@@@.@....@.
....@@@..@..........
@.@@.....@@@@@@@...@
...@@..@....@....@..
