20,20
.@..............@...
.........@.@.......@
....@......@.....@..
..@...........@@...@
.......@..@...@@....
@.......@.@.........
@......@....@.@.....
..............@.@.@.
@...................
.....@@.....@.......
@@.....@............
....................
.@.....@...@........
.@..@....@......@.@.
....@@@@@....@.@.@@.
...............@....
@...............@...
..@.....@.@.........
........@....@...@..
...................@
