20,20
..........@.@.......
....................
.......@.......@....
...................@
...........@........
....................
.................@..
..........@.@.......
..................@.
...@................
......@.............
....................
....................
....................
@...@..........@....
....................
.@............@.....
...............@....
.............@@.....
....................
