20,20
@@@@@@@@@@@@@@@@@...
@@@@@@@@@.@@......@.
@..@@@@@@.@@@@.@.@@.
@.@@@@@@@.@@@@.@@@@.
@...@@@.........@@@@
@.@.@@@@.@@@@@@.@@@@
@@.....@.@@@@@@..@@@
...@@@...@@@@@.@...@
@@.@@@@......@...@.@
@@.@@@@.@@@@.@@@.@@@
@@...@@.@@...@@@.@@@
@@@@@@@.@@@@.@@@.@@@
@.@@@...@@@@..@@..@@
@..@..@....@@@@@@.@@
@@.@.@@@.@.@@@.....@
......@@@@..@@@.@@@@
.@@@@.@@@@@@@@@.@@@@
.@@@@.@@@@@@@@@.@@@@
.@@@@..@@@........@.
@@@@..@@@@.@@@@@@...
