20,20
....................
...@.......@...@....
....@.......@.......
..@.......@....@....
....................
...................@
..@.....@..@........
...@.@..........@@@.
...........@.....@..
..@....@@..@....@...
........@...........
...@.@...........@..
.........@...@......
.................@..
...............@....
...@......@.........
.........@...@......
..................@.
@......@............
@...................
