20,20
@...@@....@....@@...
@..@@..@.@@@....@..@
...@........@@..@@.@
@....@...@@.@@@.....
....@@.@..@....@....
......@..@.@.@@@@@..
.@@@.@@....@.@@.@..@
@.....@@......@.....
.@@...@@...........@
.......@@@..@....@@.
..@.@@@.@...@....@..
.@..@.........@@....
@...@@@.@..@..@.....
@...@@.@....@....@..
@.@.........@.@@....
@..@.....@@..@....@.
.@....@...@.........
.....@............@.
@..@@..@..@.@..@....
@....@..@..@@...@..@
