20,20
.@.@....@......@....
....@...@.@.@.@.@...
...@.....@...@@.@.@@
....@.....@.@.@.@..@
.@@...@.........@.@@
@....@.........@..@@
....@.....@@@......@
.@..@.@....@.....@.@
@@..@.@.@@.@.@...@@.
@....@..@.@...@...@.
..@..@@@@..@.@.@..@.
...@......@.@.......
.@@@@...@@@......@..
....@@.........@...@
...@@..@..........@.
@...@@@@..@.@.......
........@@....@.@@..
@@...@....@....@.@..
@......@.@@...@..@..
...@..@@.@@.....@@..
