20,20
@....@.....@........
@.@@.@@.@@@..@@.@@@.
...@.......@..@..@@.
.........@..........
.@..@........@.....@
.......@.........@@.
.@....@@@....@......
...@.@@..@...@.@....
......@..@..........
@...........@.@..@..
@....@..@...@.@.....
....@....@@..@..@...
.....@@...@..@......
.@.........@....@@.@
...@.....@@..@@..@..
...@@..@@.@..@..@.@@
.@..@.....@@........
..@...@...@......@..
.@@...@..@@.......@@
.@......@.....@@@...
