20,20
@.@@.@@@.@.@...@.@@@
@.@@.....@...@......
@...@@@.@...@..@@@@.
.@@.....@@...@..@@..
.....@...@.@@.@...@.
.@.@..@@.@@....@@.@@
@..@..@.@@@@@.......
@@@..@@....@@.@...@@
..@@....@@@@@.@@@.@@
@.@...@.@@@@@.@@@.@@
@......@@..@@...@@.@
@...@@.@@.@@.@...@..
@@.@...@@..@...@...@
@..@.@@.@@....@@@.@@
.@@@....@.....@@@..@
..@@@..@@..@...@@...
..@@......@.@@.@@..@
.@....@@@@@.@....@.@
...@.@@........@.@@.
@@.@.@@.@@@.@@@@....
