20,20
.@......@...........
...................@
.......@......@.@...
.......@.......@....
.@........@.@..@....
....................
....@.....@.........
................@.@.
.................@..
..........@...@.....
...................@
..@.......@.........
.....@@.............
.....@..............
.@..@......@........
@.........@@..@@....
@@..@..@............
..@.................
....................
..............@@....
