20,20
........@..@........
...........@........
....................
...@...........@..@.
....................
.@.@...........@....
@......@...@.@......
.......@...........@
..@.........@.......
....@............@..
@...................
................@..@
.................@..
....................
..............@.....
.@.@@.@...........@.
......@..@....@@....
.@.....@..........@.
...@............@...
...........@..@.....
