20,20
@@@@@@@@...@@@@@...@
.@@@@@@..@@@@@@@.@@@
.@@@@@@.@@@@@@@@.@@@
.@@@....@@@@@@@..@@@
...@.@@.@@@@@...@@@@
@@.@.@@.@@@@..@..@@@
@....@@..@@@.@@@@@@@
@.@@@@@@..@@.@@@@@@@
@.@@@@@@@....@@@@@@@
@.@@@@@..@@@....@@@@
@..@@@@@.@@@@@@.@@@@
@@.@@....@@@@@@.@@@.
@@....@.@@@@@@@@@@@.
@..@@@@.@@@@@@@@@@@.
..@@@......@.@..@@@.
.@@@@.@@@@...@@.@...
@@@@..@@@@@.@@....@@
@@@@.@@...@....@@@@@
@@@@....@.@@@@@@@@@@
@@@@@@@@@@@@@@@@@@@@
