20,20
@.@...@.........@...
................@...
...........@@.......
.@...@......@..@@@@.
@.......@...........
...@..........@.....
.................@.@
...@...@............
....@....@.@........
....@.@.@...........
.........@..........
........@.@@...@....
@.@.....@.@@...@.@..
.@..@............@..
.....@@..@..........
..@.........@.......
.......@.@.@....@@..
...@..@@............
.....@......@.......
.......@....@.......
