20,20
@@@@@@@........@@@@@
@@@@@@@@@@.@@@.@@@@@
@@.@@@@@@@.@@.....@@
@@...@@@@..@@@.@@.@@
@@@@......@@@@.@@.@@
@@@@@@@@@.@@@..@@..@
@@@@@@@@@@@@@.@@@@@@
@@@@..@@@@@@@.@@@@@@
.....@@@@@@@@..@@...
@@@@...@@@@@@@.@@.@@
@@@@@@....@@@@....@@
@@@@@@.@@.@@@@@.@.@@
@@@@@@..@....@..@.@@
.@@@@@@.@@@@@@.@@.@@
..@@@@.........@@@@@
@.@@...@@@@@@@.@@@@@
@.@@.@@@@@@@@@.@@@@@
.....@@@@@@@@...@..@
.@@@@@@@@@@...@...@@
@@@@@@@@@...@@@@@@@@
