20,20
.......@............
...........@...@....
.@..@....@@.........
@...................
.....@..@....@......
.@...@..@.@.........
.....@@..@..........
.................@..
....................
..........@.........
....@.............@@
...@....@....@......
.............@......
.......@..........@.
......@.@...@.......
...@.........@@..@..
....................
................@@..
.........@..........
..................@.
