20,20
.@....@..@@@@.@@..@.
...@@.......@.@.@...
........@@..@.....@@
@.......@@.@.@.@@..@
@.@@.@.@.@.@.@.@.@@@
..@@@..@.@........@.
.@@.@@....@@@...@...
.@@......@.@....@...
@............@.@....
..@.....@@....@@@...
.@@....@..@.@..@..@@
@@..@.....@...@.@.@.
.....@@@@..@@...@...
.@@@.@..@.@@.@....@@
...@@@@.@......@....
.@..@....@@@.@.@.@..
..@@@@.....@...@@@@.
.@..@@@@@..........@
...@..@@.........@@@
@......@.@@...@.....
