20,20
........@...@.@...@@
...@...@.@....@.@..@
....................
...@.....@..........
.....@.....@...@...@
.@@.@..@.........@@.
....@..@@...........
....................
.@...@.....@........
..@...@...........@.
.....@..............
.@@@..@..@..@.......
@.............@.@..@
.@.@........@.@.....
....................
....@.@...@.@.......
......@.......@@....
....................
..@.....@.....@....@
.......@....@.......
