20,20
.........@..@...@..@
.@......@.@.@...@.@@
@.........@....@....
......@.@.......@@@.
@@....@...@.........
.@......@....@@...@.
.@....@.....@....@..
.....@...@.@..@..@@.
.@...@.@....@.@@...@
.@.......@.@@.@@..@@
....@..........@.@@.
..@....@....@.......
.@...@.......@@...@.
.@..@.........@.@.@.
@.......@.@...@.@...
....@..@@......@....
.@@...@.@@........@.
.@@......@@.@.@.....
..@...@...@....@....
@....@...@........@@
