20,20
@@@@........@@@@@@@@
@.@@.@@@@.@@@@...@@@
@...@@.....@.@@@....
@.@....@@.@@.@@@.@@@
@.@@@@@@@..@......@@
@@@@@@@@@@..@@.@.@@@
@@@@@@@@.@@....@.@@.
@@@@@@@..@@.@@@@.@@.
@...@@@.@@@...@@.@@.
..@@@...@.@@@@@@....
.@@@@@......@@@@@.@.
....@@.@.@@.@@@@@.@@
@.@@@@.@@@@....@@.@@
@.@@@@@@@@@@.@....@.
..@@@@@@@....@@@@...
@....@@...@@@@.@@@@@
@.@@....@.@@@..@@@@@
@@...@@@@.@@@.@@.@@@
@@.@..@@@...........
@..@@@@...@@@@@@@@@@
