20,20
........@...........
..............@.....
..@.....@...@......@
.@@.................
........@...........
....@...@........@..
...@.....@.....@.@.@
........@@..@.@.....
...@................
....@.............@.
.....@.......@......
....................
.........@.....@....
..@..............@..
..............@.....
....................
.................@..
@@..@........@@.....
.........@.....@....
...............@....
