20,20
.....@@@@@@@@@...@@@
@@@@.@@@.@@@@@.@.@@@
@@@@.......@...@..@@
@@@@@@.@@@...@@@@@@@
@@@@@..@@@@@.@@@@@@@
@@@@@@..@@@@.@@@@@@@
@.@@@@@.@@@......@@@
@.@@@...@@..@@@@...@
@.....@@@@@@@@@..@.@
@@@@.@@@@@@@@@@.@@@@
@@@@.@@@@@@@@.@.@@@@
@@@..@@@@@@@@...@@@@
@@@.@@@....@@@@@@@@@
..@.....@@.@@@@@@@@@
@.@@@.@@@@....@@@@@@
@.@@@.@@@@@@@@@@@@..
@...@.@@@@@@@@@@@@.@
@@@...@@@@@@@@...@.@
@@@@@.@@@@@@...@...@
@@@@@........@@@@.@@
