20,20
@@@@@@....@@@@@@@@@@
@@@@@@.@@.@@.@@@@@.@
@.@@@@..@..@.@@@...@
@..@@@@.@@.@.@@@.@@@
@@.@@@..@@.@.@@@.@@@
@@.@@@.@@@...@@....@
@@.......@@.@@@.@@..
@@@.@.@@..@.....@@@.
@...@.@@@..@.@@@@...
@@@@@.@@@@.@@@@@@.@@
@@@@...@@@@@@@@@@.@@
@....@.@@@@@@@....@@
@.@@@@.@@@@@@..@.@.@
@.@@@@..@@.@@.@@...@
@.@@@@@.@..@@@@@.@@@
@.@@@@@...@@@@@..@@@
..@.@@..@@@...@.@@@@
.@@.@@.@@...@......@
.@@.@..@@.@@@@@@@@@@
@@@...@@@.@@@@@@@@@@
