20,20
@...@@......@@@@@...
@.@....@@@@@@@...@@.
..@@.@.@@@@@@..@.@..
.@@@@@...@@@@.@@...@
.@@@...@......@@@@.@
@@@@@@.@@..@@..@@..@
@..@@@.@@@@@..@.@@@@
@@.@@..@@@...@...@@.
...@@.@@@@@.@..@.@@.
@@......@...@@.@....
@@@@@.@.@@.@@@.@@.@.
@.....@@@@@@...@@.@.
@.@@.@@@.@@..@..@@@.
@.@@@@@@.....@@.@@@.
@..@@@@@.@.@.@@.@...
@@.....@.@..@@...@@.
@@.@@@..@@@.@..@@@..
...@@..@@...@.@@@@.@
@@..@@....@@@@@.@@..
@@@@@@@@@.@@@@@....@
