20,20
...@...@......@@....
..@.....@...........
................@...
.@.@..@......@.@....
@.@.............@...
...@...........@.@..
@..@....@...........
@...............@...
...........@...@....
.....@.@.@...@......
.....@.@....@@.@....
..@....@..@......@..
......@.@........@..
............@....@..
..............@.@...
....@...@.......@...
...@.............@..
.........@..@.@..@..
.....@.@..@....@...@
..............@.....
