20,20
.@@....@.......@....
........@.@@@.@....@
...........@..@.....
.@......@..........@
@@.@@@.@............
.........@.......@..
...@@.@....@.@@...@.
......@.....@@......
..@@........@....@.@
.@.........@........
@...@........@.....@
....@.....@.......@.
@@.@.........@...@..
...@.@@.@........@..
..@......@....@.@..@
.@.@....@....@......
...@@...@....@.@....
@..@....@..@.......@
..@.................
@@.....@............
