20,20
...@..@.........@...
...@....@.........@.
.@....@@........@...
@@@...@@...@......@.
@.....@.........@...
.@...@@..........@.@
.....@@@............
.....@.........@..@.
@@@.......@..@......
..@.....@.....@.@...
.@.@.@.@.......@....
......@.@...........
..@.@.@...@..@@@....
@.........@.@.......
@.......@...@@@.....
...@...@...@........
..@.......@.@....@..
..@..@......@....@.@
.......@...@.@.....@
..@.............@...
