20,20
.@@@@@@@@.@@@@@@@@@@
.@@@@@@@@.@@@@..@@.@
.@.@....@.@@@@.@@..@
...@@@@...@@@..@@.@@
@.@@@@@@.@@@@.@@@.@@
@.@@@..@..........@@
@..@@@..@.@@@.@@@.@@
@@....@...@@@.@@@..@
@@@@@.@@@.@@@@@@@.@@
......@@@..@@@@@@.@@
@@.@.@@@@@.@@@@@@@.@
@..@..........@@@@.@
@.@@@@@@.@@@@.@@@@.@
....@@@@...@@......@
@@.@@@@@.@.@@@@.@@..
@@.@@.@@@@.@@@@.@@@.
@@.@@......@@@@.@@@.
@@.@@@@.@@.@@@@@@@@.
@..@@@@@@@....@@@@@@
@@@@@@@@@@@.@...@@@@
