20,20
..........@.........
....................
....................
.@..................
........@...........
..........@......@..
...@................
............@....@..
.........@..........
@@...........@......
....................
....................
.@............@.....
....................
....................
...@..........@.....
.@................@.
....................
....................
.........@........@.
