20,20
..@.....@@..........
..@@@.@...@.@.@@.@..
...@......@.@....@@.
........@..@@.@.@..@
...@...@@..@........
.@.@...@@........@@.
...@...@@...@..@@..@
@.@.@@....@@.@@@..@.
.@.....@@....@.@@...
....@....@@@...@..@.
....@.....@.@..@...@
.@..@@...@....@.....
.@@.@..@..@.@@@.....
.@...@@......@..@@..
@@@@.....@@@.@...@..
...@@@..@..@@.@.....
@........@..@...@..@
..@...........@...@.
......@.@..@@..@@...
.....@...@....@...@.
