20,20
@....@@@@@@@@@@@@@@.
@.@.@@....@@@.@.@@@.
@.@.@@.@@@@@@...@@@.
@.@....@..@@@.@@@@..
@.@@@@...@@@@.@@@@.@
@..@@@@@.......@...@
@@.....@..@@@@...@.@
@@@@@@@@@..@@@.@@@.@
@@@@@@@@@@.@@@@@@@.@
..@@@@@@@@..@@@@@@@@
@.@@..@@@..@@...@@@@
@..@@...@@.....@@@..
@@....@.@@.@@@......
@.@.@@@..@.@@@@@..@@
@....@@@...@@.@@@.@@
@.@.@@@@@.@@..@@@...
@.@...@@@..@.@@@..@.
@.@@@@@@@@...@@@...@
..@@@@@@@@@@.@@@.@..
@......@.....@@@@@@@
