20,20
...@..@.@@..@....@@@
@@..@.......@@@....@
@@@..@.@@..@..@.@.@@
......@.@@.@....@@..
..@@@....@.@..@.....
.@.@@@@..@...@.@....
@..@@...@@.@@@...@@.
@.@.......@..@@..@@.
@....@.@..@..@@.@@..
@@@@@...@@..@@@@....
...@..@....@@@@@.@.@
..@@.@........@..@..
....@.@@@...@@..@..@
..@..........@.@..@@
...@@.@.@@.@@@...@@.
...@..@@@@.......@@.
@@.@.@@.@...@.@.....
@@@.@@..@.@@@.@..@@.
..........@...@....@
.@@.@@@@.@@@@@......
