20,20
.@.......@@.........
..@.@@...@..@....@..
......@@............
...............@....
....................
...@......@.........
...............@..@.
.@@.................
.@.......@..........
...@....@...@..@.@..
...@.....@.@....@...
@.........@....@....
...@...........@....
.@.......@...@...@..
.@..@@...@..@....@..
......@@....@.......
.@........@.........
.@.@........@...@..@
@.@............@@...
@.............@.....
