20,20
.@@..@@@....@@.@@...
.....@@.@..@.@.@..@.
..@..@@....@.@.....@
@..@.@@.@@.@.....@@@
@..@.@@@.@.@.@...@@.
...@.@.@.....@.@..@.
.@@@......@....@@@@.
@@.@@....@....@.@@..
@@.@....@..@..@.@@.@
......@.@@..@...@@..
......@.@...@......@
@..@.@@@.@.@@.@.@..@
...@...@...@...@@...
.@.@..@@@@..@.@.@...
.@@@@.@.......@..@..
@@@....@..@.@@@..@@.
.@@.@@.@@..@@.@@..@.
.@..@..@@@.@@...@.@.
.....@@@...@....@...
.@@..@@@.@....@.@.@@
