20,20
..@@@@@@.@.@@.@..@@.
@....@@@......@.@@..
..@@.....@.@.@.....@
.@@@@@@@..@@...@...@
@@@...@@..@@..@...@@
@....@...@..@@@@.@..
..@@@.@.....@......@
..@@@..@@@...@@.....
.@.@.@.@@......@@...
.....@....@.@.@@@.@.
.@@.@@...@..@@@@..@@
.@@....@..@..@@....@
@@@.@.@....@...@.@@@
@@.@...@@..@.@..@...
.....@..@.@..@@.@@.@
.@.@.@@..@@@..@@.@..
@.......@....@@.....
@@.@..@..@.........@
.......@..@..@@.@@.@
@.......@@@@@......@
