20,20
..@@.@@@..@@@@@@@@.@
...@.@.@.@@..@@@.@..
.@@@.@....@@.@@....@
.@@@.@@.@@@......@..
..@@.@@.@@.@@@@...@.
@.@..@@....@@@@.@@@.
@...@@@.@@@......@@@
@@.@@....@..@@..@@@@
...@@.@.@..@@.@...@@
.@....@.@@.....@@.@@
...@@.@..@@..@.@@@@@
.@@@..@..@.@.@.@@@@.
..@@@.@@.....@@.@...
@@....@@.@.@@@..@.@@
@..@@..@@@..@@.@...@
@.@.@@@@...@@....@..
@....@@..@@@@.@@@...
@.@@@@@.@.@.@.@@...@
@...@..........@.@..
@@@.@@@@@@@@.@..@...
