20,20
....@@@@@..@@@@..@@.
.@@...@..@...@@.@@..
.@@@@.@@.@@@.@@..@@.
@@@...........@@.@@.
@@@.@@@@.@@.@..@....
.@...@@@.@@@@@.....@
...@...@@@.@@@@..@..
@..@.@.@@.......@@@@
.@.@@..@..@.@.@.....
....@@@@.@@@@.@@.@@.
@.@..@.@@@@...@@.@@.
@@...@...@@.@@@@@@..
@@...@@@.@@@@@.@@@@.
.@.@......@@@....@@.
.@.@@@@@..@...@@..@.
.@......@@.@@...@..@
...@..@....@@.@.@@.@
@.@@.@...@....@@@..@
..@@.@.@.@@@.@.@@.@@
@@@@.@@@.@@@...@@.@@
