20,20
@@@@@@@@@@@@@@@....@
@@@@@@@@@@@@@@@.@@.@
@@......@@@@@.@@@..@
@@.@.@@.@@@@@.@@@@..
@@.@...@@.......@@@.
@@.@.@....@.@@@.....
.@@@.@@@@@..@@@@.@.@
.@@@.@@@@@@.@@.@.@..
.....@@...@..@...@@.
@.@@....@.@@@@@@@@@.
..@@@.@@@.@@@@@@@...
.@@@@..@@@@@..@@..@@
...@@@.@@@@@.@@..@@@
@.@@@@.......@@.....
@@@@@@.@@@@@@@@.@@@.
@@@@@@.@@@@@@@@.@@..
@@@@@@.@@@@@@@@@@..@
@@@@......@@@@@@@.@@
@@@..@@@@...@@....@@
@@@@@@@@@@@@@@.@@@@@
