20,20
...@@@@@@@@@@@.....@
.@.@@....@@....@.@.@
@@.@@.@@.@@@@@.@@@..
@@....@@.@@@@@...@@@
@@@@...@.@@@@@.@..@@
@.@@.@.@..@@@@.@@...
@..@.@.@@.@@@@..@@@@
@@.@@@.@@.@..@@..@@@
@...@@@@@...@@@.@@@@
@.@...@@@@.@@@@..@@@
@.@@@.@@.....@@@....
@.@@@....@.@..@@..@.
..@@@.@.@@.@@....@@.
.@@@@@@.@@.@@@@.@@@@
....@@@..@...@@..@@@
@.@@@@....@@.@@@.@@@
@.@@@@@.@@...@.@.@..
@....@@.@@@@@@.....@
@.@@@@@..@@@@..@@@@@
@..@@@@@.@@@@@.@@@@@
