20,20
@@@@@@@@@@@@@@@@@@@@
.@@@@@@@..@.@@@....@
..@@...@@...@.@.@.@@
@.@@.@.@@@.@@...@.@@
@..@.@..@@.@...@@.@@
@@...@@.@....@.@@@@@
@..@..@...@@@@.@@@@@
..@@@@@.@.@@@@.@...@
.@@@@@@@@.@@@@...@.@
.@@@@@@@@....@@@@@.@
...@@@@@@.@@.@@@@@@@
.@@@@@@@@.@@..@@@@@@
.@....@@@.@@@...@..@
...@@@@@@.@@@.@...@@
@@@@@@.....@@@@@.@@.
@..@@..@@@.@@@@.....
@.@@@@.@@@@@@@..@.@@
@...@@.@@@@@...@@.@@
@@@....@@@@@@@@@@..@
@@@@@@@@@@@@@@@@@@..
