20,20
....@@...@..@@...@..
.@@.....@.....@..@.@
.....@@....@@@......
..@@.....@.@.@..@.@.
....@..@..@@.@...@..
@..@....@..@.@......
...@...@..@.....@@.@
.@.@..@....@.@@.....
.@@.@@.@..@..@.@@...
@..........@.......@
.@..@..@.........@..
....@@.@..@@@@@@....
@..@...@@...........
..@@@...@.@...@.....
.@........@@..@....@
...@@..@.@.....@....
..@@@..@@.@@..@.@.@.
@..@@@@@@..@..@....@
...@........@......@
@...@@........@@....
