20,20
...@.......@.@...@@@
..@...@.............
..@.@..@......@..@..
.@..@@...@@.....@...
..@.@..@.....@..@@..
.@..@..@@...@.@.....
........@.@@.....@..
.@@.......@.........
@....@....@.@.....@.
.......@....@.......
@.....@..@@@@.....@.
@..@.....@....@.@...
....@.....@......@@.
...@@@@..@...@......
.@@....@@....@.@@.@.
@.@@..@......@@@...@
.......@...........@
.@@..@...@......@@..
.@.@............@...
@.....@.@..@@...@...
