20,20
.@.......@.....@@...
..@.@@..@.....@.....
@..@....@@@@..@@.@..
.@.@..@@..@..@...@@.
...@@.@..@.....@...@
@.@.@......@....@@@.
....@@.@@@.......@..
.@....@.....@@@.....
...@@.@.....@...@...
...@@..@@....@@..@.@
@...@.@.............
@....@........@@....
......@..@...@..@@.@
@.....@@@......@@.@@
@.@.@...@.@@..@.@...
@@...@.@.@@@..@....@
.............@.@@@..
.@.....@.@..........
@@....@..@.@.....@.@
@.....@......@@..@..
