20,20
......@@@@@.....@@..
..@@@.@@......@..@.@
.@@@....@...@..@@...
..@.@...@.@@@@@@@..@
.@@.@@.@.....@@.@@..
..@.@@...@@@.@......
....@..@@@....@@.@..
@@.@@.@..@@.@@......
@@.@..@........@....
..@..@.@.@@...@.@..@
..@@@..@@@@.@@..@.@@
..@@@.@.@.@.@@@....@
.@....@....@..@.@..@
....@...@.@@@...@..@
..@@..@.@@@....@@..@
@..@@.....@..@@.@@@@
@..@@@.@..@@.@....@@
...@..@@..@@...@....
...@.@@@@....@.@...@
.@...@........@....@
