20,20
.....@..@@@.@@@@@@@@
@.@@.@........@@@.@@
@@@@...@..@@@.......
@@@@.@..@....@.@@@@@
.....@@@@.@@@..@@@@@
@@@@...@@.@@....@@..
@@@@.@@@@.@@.@@.@@.@
..@..@@@...@@@...@.@
@.@.@@@@@@.@@@@@....
@....@@@@@.@@..@@@@@
@@@@.@@@...@@...@@@@
@@@@..@@@..@@@.....@
..@@@.@.@@..@@@@.@..
@.@.....@@@@@..@.@@.
...@@@.@...@@.@..@@.
.@...@...@@@@...@@@.
..@@.@..@.....@.@.@.
..@@.@.@..@@@@....@.
.@@@...@.@@@@@.@@@@@
..@@.@...@@@@@@@@@@@
