20,20
.....@..@@.....@@...
@@@....@@@.@..@..@@.
@..@..@@.@.@..@...@.
.@....@....@@@..@...
....@....@@...@...@.
.@..@..@@@@....@@...
@@.@....@@@.@@@...@@
....@..@@....@..@@..
@........@@.@....@@.
...@@....@......@...
.@.@.@....@....@@..@
@.@...@..@.@@..@@..@
..@@..........@@..@@
..@@.@@@..@.........
...@@.....@@....@.@.
@@....@@@@..@@..@.@@
@@..@.@....@@...@...
.@......@@....@....@
...@.@.@@@@@@..@....
.@@...@@........@...
