20,20
..@........@@@......
...@....@..........@
..@.......@.........
..@....@....@....@.@
......@.....@...@@.@
.@..@@.@..@.....@...
...........@...@...@
.@...@@@....@@.....@
@......@...@..@@....
..@.....@....@......
@@..@.......@..@.@..
....................
@..@@@.............@
.@......@.@....@....
.......@...@.@...@..
.......@.@.@........
..@.@..@...@...@..@.
.@..........@@..@...
...........@....@.@.
....@............@..
