20,20
.@....@..@..@...@@@.
..............@..@..
.............@.....@
.......@............
.......@@.........@.
........@..@....@@@.
.@.@@..@........@@..
..@....@.......@..@@
@.@........@@.......
...........@@@.....@
....@@.........@....
@@..................
...........@@.....@.
..@@..@...@...@@....
.@............@.@...
....@...@@....@...@@
@...@.....@@...@..@.
...........@.@.@....
@@.@.@......@.....@.
.............@..@..@
