20,20
@@@@@..@@@@@@..@@@..
.@@@@@..@@.@@.@@@@.@
.@@@@@.@@@.@...@...@
..@@@@......@@.@@@.@
.@@@@@@@@.@....@@@..
.@@@@@@@@@@@.@@@@@@.
.@@.@@@@@@@.........
....@@....@.@@..@@@@
.@@....@@@@.@@.@@@@.
@@@@@.@@@@@..@.@....
@@..@.@@@.@@.@.@@.@@
@@....@@@..@@.....@@
@@.@@@@.@@.@@.@@@@@.
@@.@@@@.......@..@@.
@@.@@@@@.@@@@@@@....
@@..@@@@..@@@@@@.@@.
@@@.@@@@@.@@@@...@@@
@.......@......@...@
@.@@@@@.@@.@.@.@@@.@
@@@@@@@....@@@.@@..@
