20,20
@@.@@@@@..@@@@@@@@@@
.........@.@@@.@..@@
.@@@.@..@@.@@@...@.@
.@@@.@@..@.@...@....
.@..@@@@....@@@@.@.@
.@@.@@....@.@@@@.@..
@@@.@@@..@@@@@@@@..@
@@@.....@@.@@.@@@.@@
@.@@@.@@.@.@@.@...@@
@...@....@....@.@@..
@@@.@.@@@@.@@....@@.
@@..@.....@@@@@@.@..
@...@@@.@...@@@@...@
@.@@@@@.@@@..@@@@.@@
..@@.@@..@@@.@....@@
@.@@..@.@@.@@..@@.@.
...........@@.@@@...
@@@@@@@@.@@@@.@@@@.@
@@@@.@@........@@@..
@@......@@@@@@@@@..@
