20,20
@@@..@.@@@...@@....@
..@@.....@.@.@..@@..
@.@@.@.@@..@@@@@....
@....@.@@@....@@.@@@
@.@.@....@@.@.@...@@
.....@.@...@@.......
.@@@.@@@.@.@..@..@.@
...@.@@..@.@@..@.@.@
@..@@@@.@@..@.@..@@@
@@....@@....@..@.@@.
...@@@.@.@@..@.@@@..
..@@@@.@@@......@@.@
...@.@......@..@...@
@.@..@@.@@@@..@..@..
@.....@.@@@....@.@.@
.@.@@@@...@.@@....@.
.@.@@@...@@.@@..@...
.@.@@@@.@.@.@@.@@@@.
...@.......@@...@@..
@...@.@.@@.@@..@@..@
