20,20
@............@.@....
..@@..@....@.......@
..@..@@.............
..@...@@@.@....@....
.@@..@@......@...@..
@@..@.........@@.@..
..@......@@....@....
....@@..........@@@.
@........@....@.@.@.
...........@@.......
@......@.@....@.....
...@...@.@.......@@@
...@.....@...@@.@@.@
@@.@@..@.....@@..@..
..@@@..@@@........@.
.@@..@.....@.@......
.............@.....@
.@@@.....@.......@.@
......@....@......@@
@.@........@.@@.@...
