20,20
@........@@...@@@@..
@@@...@...@.@@.@..@.
.@..@@..@.@....@@.@.
.@@...@.@.@.@@.@....
.....@@@@...@@.@..@.
.@@@.....@..@....@@.
@@....@@@@@@@@.@@.@@
@@@...@@@.@....@...@
....@@.@@.@..@@..@.@
@@@..@.....@@@@.@@.@
@...@..@@@.......@..
@.@@...@@@.@.@.@@...
@.@..@@@@..@@.@@.@.@
......@@@.@@@.......
@@..@..@@.@@....@...
@@@....@...@@@.@@@@.
.@..@@@@.@@@@@...@..
...@@@@@@....@@@@.@.
@...@@@@@@.@..@.@...
..@..@@.....@.....@.
