20,20
@@.@@.....@@@..@@@@.
.@.@..@@.@..@.@@@@..
.....@...@.@...@@@@.
@.@@@@..@@.@..@@.@@.
..@@@@.@@@....@@....
@@@....@@@@@@....@@@
@@.@@.@@.......@...@
@@....@@@.@@@...@@.@
.@..@@@@..@@@@@.@@.@
...@@@.@@...@@@@@@.@
@@.@@...@...@.....@@
...@@@..@@.@@..@@..@
....@.@..@....@@@@@@
.@@........@.@@@@@.@
@@...@@@@@.@@@..@..@
@..@@@...@.@@.....@@
@@@@@..@.@..@.@@@...
.@@@@@.@...@@.@@.@@.
.@.....@@.@.@.@.....
...@@@@@......@@@@..
