20,20
@@@.@@@.@@@@.@@@@..@
@....@@.@@@@..@@@@.@
@@.@@@@.@@@@@.@@@..@
@@..@@@...@@@..@@.@@
@@@.@@.@.@@@@@.@....
@...@@...@@@.@...@@.
@@@.@@@@.@@@...@@@@@
@.@........@@..@@@@@
@.@.@@@@@@....@@@@@@
@...@@@@@..@...@@@@@
..@@@@@@@@@@@@....@@
.@@@...@@@@@@@@@@@@@
..@..@@@@@.....@@@@@
@...@@@@@@.@@@.@@@@@
@.@@@@@....@@@.@@@@@
@.@.@@@.@@.@@@.@@@@@
@........@.@@@.@.@@@
@@.@@.@@@@.@@@...@..
@@.@@..@@@..@@@@...@
@@.@@@.@@@.@@@@@@@@@
