20,20
..@@..@..@...@...@.@
.@........@...@@....
.@.....@........@..@
...@@..@.....@@@..@@
.@@.....@....@.@....
....@.@..@...@..@...
......@@..@@...@....
..........@.@@@...@.
........@......@@.@@
..@@@..@..........@.
....@@.....@........
..@...@.....@.....@.
@.@....@@...@...@.@.
.@..@.@.......@....@
.@.@............@.@.
....@@....@.........
@@.@@...............
@.@....@.@.....@@...
..@...@.@@@...@@....
..........@@...@..@.
