20,20
.@@.@@@..@..@.....@.
.@.........@@@.@.@..
........@..@...@...@
@@@@@.@....@....@...
.@.....@.....@......
..@....@@@..........
..@@@@..@....@@@..@.
@.@.@..@.@@@....@..@
@...@..@.@@....@..@@
@..@..@...@....@...@
...@..@...........@@
.@....@.@@...@.@...@
........@...@...@...
.@@...@.@.@....@@@..
...@....@@.@........
@.@...@........@@.@.
@@.....@.@......@..@
...@.......@..@.@..@
...@@.....@.@..@.@@.
@..@@...@...@.......
