20,20
...@@@@@@.....@@@.@.
@.@....@@....@@.....
@.@.@@@.@@@@....@..@
........@...@.@.@@@@
.@..@@.@@.@@....@@.@
@..@@@@@@....@@.....
..@.@@.@@.@@...@@..@
@.@.@@..@....@.@@..@
@...@@@..@@@.....@..
@...@@@@.@@@.@@@.@.@
..@@.@.@.....@@.@@.@
.@@..@....@@.....@@@
...@.......@@@@@.@.@
@.@@@.@@...@@@......
@....@...@@@.@.@@@@@
....@.@......@@...@@
.@@...@@..@@.@@@.@..
.@........@....@...@
@..@.@@@@........@.@
@@@@..@@@@.@.@@..@@@
