20,20
...........@........
@...................
...............@....
....................
.........@.@........
..............@.....
...............@....
.................@..
................@.@.
................@..@
...................@
.......@............
.........@..........
...............@....
....................
...................@
..................@.
..............@.....
.........@..........
....................
