20,20
....................
......@...@....@@.@.
.........@..@.....@.
....................
..........@......@..
@@@..........@......
....................
...........@.@.@....
@@........@.........
.....@...@@.....@...
..................@.
...............@....
............@@......
.@@.......@.........
.........@...@......
.......@........@@..
.......@......@.....
...........@........
.....@..............
....................
