20,20
@@...@..............
.......@...@.@......
.....@.@....@...@...
.....@...@..@@......
..........@@@.......
.......@..@...@.....
@@.........@.@......
@.....@.......@@@...
...@.......@....@.@.
.@...@@@.@...@..@...
..@......@@@........
..@..@....@.....@@.@
@..@........@.....@.
........@.......@...
....@.@.............
@@........@..@@...@.
......@.....@...@.@@
..@.@.........@@..@@
.....@.........@....
....@...@.........@.
