20,20
........@@....@.@@.@
@..@................
.....@..........@...
.@.........@.@......
....@........@.@..@.
.....@..@......@....
@........@....@.@...
......@.@.....@.....
...@......@....@....
.........@..@.@..@..
..@..@....@.........
....@.....@.......@.
........@.@.........
.....@..@....@@.....
.......@.........@..
.................@..
@.........@...@..@..
@............@.@...@
...........@........
.@........@.........
