20,20
@.@@@@@@@@@@@@@@@@.@
@....@@@@@@@@.@....@
@@@@.@@.....@...@.@@
@@@.....@@@.@@@@..@@
@@@.@@@.@@@.@@@@.@@@
@@@.@@@@@@..@@@@..@@
.@..@@@@@@.@@@@@@.@@
...@@@@@@..@@@@@@.@@
@@@@@@@@@.@@@@@@@.@@
@@@@@@@@@.@@@@....@@
@@@@@.......@@.@@@@@
@@@.@.@@@@@....@@@@@
@@@.@.@@@@@@@@.@...@
@@@...@@@@@@@@...@..
@@@@@.@@@@@@@@@.@@@.
@@@@@.@.........@@..
@...@.@@@.@@.@@.@@.@
@@@...@@@.@@.@@.@@@@
@@@@@@@@@.@@@....@@@
@@@@@@@@@.@@@.@@@@@@
