20,20
@..@...@..@@.@@@@@..
........@.@.........
.@........@..@@...@.
.....@.@..@.@.@.@.@.
.@...@@@..@...@@@.@.
@...@@@.@.@...@@@...
@..@@.@.....@.@..@..
@@.....@@@@..@@.....
..@@..@....@@..@....
.@.@..@.@.@@@..@@@.@
....@.@..@..@..@@...
..@........@.....@..
@......@.@@.@..@.@..
@.@.@..@@...@@@@..@.
@.@@@@...@.@@.@@....
@.@@........@....@.@
.......@..@@..@..@@.
..@.@.@@.@@..@.@.@..
........@@..@.......
@@@......@.@.....@..
