20,20
..@..@...@..@..@..@.
....@.@....@.@......
..@@...@.@.......@..
...@.@.....@.@......
.@.@....@.@..@..@...
@....@@.......@@....
.@@......@@...@@.@..
..@....@.@......@...
.@..@..@......@.@@..
.@....@@...@..@.@...
.@.....@.@......@@..
.@.......@.@......@@
.@....@.@...@.....@@
......@..@....@@.@..
@.@.@....@@.@@......
...@@..........@....
.@...........@.@..@.
.@.@@.....@@..@.....
...@.....@.....@@...
..............@....@
