20,20
@@@@...@@@@@@.....@@
@@@@.@@@@@@@@.@@@.@@
@@@..@@@@@@@@.@@@...
@@@.@@@@@@@@@.@@@@@.
@...@@@@@@....@@@@@.
@.@@@...@@.@@.@@@...
@.....@..@.@@@@@@.@@
@@@@.@@@.@.@@@@@@@@@
@@@@.@@@.@.@@@@@@@@@
@@@@.@@@....@@@@@@@@
@....@@@@@@...@@@@@@
@.@.@@....@@@..@@@@.
@.@@@@@@@.@@@@.@@@..
@.@@@@@@@.@@@@..@@.@
@..@@@....@@@@@.@@.@
@@.....@@.@@@@@..@.@
@@@.@@.@@...@@.@.@.@
@@@.@@...@@.@@.....@
@@@@@@.@.@@@@@@@@@@@
@@@@@@@@@@@@@@@@@@@@
