20,20
....@...............
.......@@...........
....................
....................
...................@
........@...........
....................
....................
............@.......
...............@@...
................@...
............@.......
.@..@...............
...@................
..@.................
....................
......@......@......
...................@
.@.....@..@.........
....................
