20,20
@.@@@@@@@@@..@@@@@..
.....@.@@@@@.@@...@.
@@@@...@@@@@....@...
@@@@@@.@.@@@@@@.@@@@
@@@@@@...@......@@@@
@...@@.@@..@@@@.@..@
..@.@..@@@.@@@@.@.@@
.@@...@@...@@.@...@@
@@@@..@@@@@@@...@@@.
..@...@@@@@@@.@@@@@.
.@@.@...@@....@@@@..
....@@.....@@...@@.@
.@.@@@.@@.@@@@@.@..@
@@.@@@@@@...@@@...@@
@@@@..@@@@@.@@@@@..@
@.@..@@@@@@....@@@..
..@@.@@@@@@.@..@@@@.
@.@@...@@@@.@@...@@.
@....@......@@@@.@@.
@@@.@@@@@@@@@@@@@@@@
