20,20
.@@.@.....@@..@.@@..
......@.@@.@@...@...
@@..@@@..@....@...@.
......@...@..@......
..@@.@@......@..@...
.@...@.@.@....@.@@..
.@@@...@@@.@.@..@@.@
.@......@..@.@@..@..
..@..@..@.@...@@@@.@
..@......@@@@.....@.
.@..@.@.@..@...@....
@..@..@.@..@...@@.@@
...@.@..@..@@...@..@
@..@...@..@@@@@@....
@..@@.@@@....@.@....
.@..@.@.....@...@.@@
.....@@@@.@..@......
@@.@......@.@...@@..
...@.....@.@..@.....
.@.@........@..@@.@@
