20,20
..@....@..@......@@.
.@@........@...@@...
...@@....@..@..@.@..
....@@...@@...@.....
..@.@........@....@.
...@........@.......
@.......@@..@@.@@...
..@.@.....@..@...@@.
.@..@@.....@........
......@....@........
@......@...@..@.@@..
@....@....@@...@..@.
..@.................
.@..@....@.....@....
.@...@..............
..@..........@......
......@..@...@.....@
@@............@....@
.......@...@@.......
...........@@.......
