20,20
@.....@.......@....@
............@..@....
.@.....@..........@.
@.........@.@@......
...@..@...@@........
..@..@..............
....@..@@...........
.............@.@....
..@........@@@.@..@.
.......@..@........@
.....@@.............
@.................@.
.....@......@.....@@
.....@..............
.........@....@.....
......@.....@...@...
.....@....@......@@.
................@@@.
.....@...@..........
..@@...@.@..........
