20,20
@......@@.......@.@.
...@........@.......
..@.......@.@@......
@.@.......@.....@@@@
..@..@@@..@@........
.....@.@@@.........@
.............@......
@.@..@....@..@..@@.@
.@.@......@.@@.@....
....@@@.........@...
..@....@.@...@...@.@
......@..@....@.@.@@
..@@.@...@@.........
.........@@.......@.
..@@..@@.......@@..@
.@.@....@.@.@...@.@@
......@..........@@.
..@@......@......@..
@@@....@.@..........
.....@.@......@..@.@
