20,20
..............@..@..
...........@....@...
...@......@@.....@.@
..@.@.@@..@...@.....
.@@...@.....@@@.@...
..@@.....@@.........
.@.....@.@.@....@.@.
.@@..@............@@
.@.@........@.@.....
.......@@...........
@............@...@@.
....@.....@....@...@
@.@..@...@@...@.....
..@@..@..........@@.
...@..@.@@.@..@..@@.
.@..@@....@@........
..@@@....@....@..@@.
.....@@..@@.@...@@@.
.....@@@@.......@...
......@.....@@..@@..
