20,20
@@.@...........@@@@.
....@.@@@@.@@@...@@.
.@....@.@@@@.@@@@@@.
.@@@@...@.@@.@@@@@@.
@@@.@@.@@....@@@....
@@@.....@@@@...@...@
@@@.@@@......@.@@.@@
@@..@@@.@@.@..@@@..@
..@@@...@@..@...@@..
@.@@@.@@@@@.@@.@@..@
@.@@@.@..@@@...@@@.@
@.@@@@@..@@@.@.....@
...@@@@.@@...@.@.@.@
.@.@.@@..@@@.@..@@.@
.@@@.@@.@@@..@@@...@
.@.@..@...@...@..@..
.@...@.@....@..@..@.
.@@@.....@@@@.@..@..
...@.@@...@@.@@...@.
@@...@..@.....@@.@@@
