20,20
....@@@@@@@.......@@
.@@.@@@@....@@@@@..@
.@@@@@@@@.@@@@@@@@.@
..@@@@@@@.@@@@@@...@
@.@@@.....@@@@@@.@..
@.....@@@@@.......@.
@@.@@@@@@@@.@@@@@@..
@@.@@@@@@.@@@@@@@..@
@..@.@@@@.@@@@@@..@@
@@@@.@@@@.@@@@@@.@@@
@@@@...@@.@@.....@@@
@@@@@.@@...@.@@@.@@@
@@@.@.@@.@...@@@...@
@.....@@@@@.@....@.@
..@.@@@@@@...@@@@@.@
@@@.....@@.@..@@@@.@
@@@@@.@.@@.@@.@@@..@
@@....@.@@.@@.@@@.@@
@@@@@@@....@@.@@@...
@@@@@@@@@@@@@@@@@@@@
