20,20
@@@@...@@@..@.@@@@@.
@....@@@......@@@@..
@.@@..@@..@@..@@@@.@
@@@@..@@.@@@.......@
.@....@...@@@@@.@@@@
.@@.@...@...@@@....@
..@@@@@.@@@..@@.@@@@
.@@...@.@...@...@@@@
.@..@...@.@@@.@@@.@@
.@.@@@.@@@@@..@@@..@
....@@..@@@..@@...@@
@@.@@.@.@@@@..@@@..@
@..@@.....@@@.@@@@.@
@..@@.@@@...@...@..@
@@.@@..@..@@@.@@@@.@
@..@@@@@@.@@........
@.@.@@.@@.@@@.@@@@.@
@@@.@.....@@@.@@@@.@
@@....@.@@.....@@@.@
....@@@@@..@..@@@@@@
