20,20
@...@...............
.@...@...@@@........
...@.......@.......@
@@.....@...........@
.@.@...@.@......@...
..@.....@.........@.
....@@.@..@...@.....
..@...@.....@@..@@@@
.@@@@.....@.....@@..
....@....@......@...
.@...............@..
.......@@........@..
.......@..@...@@....
......@@......@.....
.................@..
.@..@..@.......@....
.....@........@@@...
.@@...@.@.@........@
...@...@..........@.
@@....@...@..@......
