20,20
@.@......@...@@....@
...@...@.@....@.@@..
..@.@...............
.............@.@@.@.
@..@@@..@....@@.....
....@........@......
..@.@.@.@........@..
.......@...@....@@..
....@......@.......@
..@..@..@.@.....@...
.......@..@......@@.
.......@@...@@...@..
@...@..............@
@......@.......@..@.
........@........@..
@....@..@@..........
............@...@...
....@@.....@.@@@.@..
..........@...@..@..
....@.......@.......
