20,20
..@.@..............@
........@..........@
...........@@.......
.@...@.....@........
..@.@..@......@.....
.........@....@.....
.@.@.............@.@
.....@..@...........
......@.....@..@@.@.
............@..@..@@
....@.....@.........
........@...@..@....
.@...@...@..........
............@......@
.@..@.@.............
....@.@...@.....@...
.....@@........@..@.
@..@..@......@......
.@...........@......
....@......@........
