20,20
@...@.@@...@@.......
@@.@..@.....@@@@@@..
.....@.....@..@@@@.@
@..@@..@.@......@..@
@.@@@@@.@@@.@.@@@..@
..@@......@..@@@@.@@
.@.....@.@....@@@.@@
...@@.@@....@@....@.
.....@@@..@....@@...
@.@@.@.@@@@.@@.@.@@.
..@@@@...@@@.@...@@.
..@@@...@@@@......@.
.@....@@@.@@.@@@.@..
@@..@.@.@.@..@@@@@@@
@@.@@...@.@@...@@@@@
@@@...@@@.@@.@..@...
........@..@.@@.....
@.@@.@.@@@...@@.@...
@...@...@@...@.@@.@.
@.@.@.@........@@.@@
