20,20
...@@..@..@..@@...@@
.......@.@.@..@.@..@
.@@..@@@......@@...@
..@@..@@@@@...@..@@.
@@@..@@.............
@.@.@@@.@@..@..@.@@@
..@..@@.@@@..@..@@..
..@.....@@@@.@@.@@.@
@.....@@.@@..@@@....
@@.@..@..@@@....@...
....@...@@...@@@@.@.
.@.@..@@@@@.@@@@@.@.
..@...@@......@.....
.@@@...@.@.@.@@..@@.
@@@...@..@@@....@@@.
@@..@@@@@.@@..@@@.@.
..@@.@@.@.@@@.@...@.
.@@@.@@.........@..@
........@..@@@.@....
.@@@@@@@@@.@@@@@.@@.
