20,20
......@@@@@@@@@@@@.@
.@.@@..@.........@..
@@.@@@@@.@@@@@.@...@
@..@@@@@.@@.@@.@@.@@
@.@@@@...@@....@@..@
@.@.@@.@@@@@.@..@@@@
@...@@....@@.@..@@@@
..@@@@@.@..@@@@.@@@@
@.@@@@..@@@@@@@.@...
@.@@@..@@@@@@@@...@.
@.@@..@@.@@@@..@@@@.
@.@@@.......@@.@@@@@
@.@@@@@@@@@.@..@@@@@
@.@@....@@@...@@@.@@
@....@@..@@.......@@
@.@.@@@@....@@@@@...
..@...@@@.@@@@@@@@.@
.@@.@...@..@@@@@@@.@
.@@.@@@@@@.@@...@@.@
@@..@@@@@@.@@@@....@
