20,20
@@@@@@.@@@@@@@@@@@@.
.@@@@@.........@@@@.
..@@@@@@@.@@.@......
@...@@@@@.@@.@@@@@@@
@.@...@...@@@@@@@@@@
@@@@@.@.@@@@@@..@@.@
@@@@@...@@@@@@@.@@.@
@@@@@@@.@@@@@@@.@@..
@@@@@...........@@@.
@@@@@@..@@.@@@@.@@..
....@@@.@@.@@@@.@@.@
@@@.....@@..@@@.@@.@
@@@@@@.@@@@@@@.....@
@@@....@@@@@@@@@@.@@
@@@@@@...@@@@@@@@.@@
@@@@@@.@.@@@@@@@@.@@
@@.@@@.@.@@@@@@@@.@@
@@.@@@.@.@@@@@@@@.@@
@@.@@..@...@@@@@@@@@
@@....@@@@@@@@@@@@@@
