20,20
@.......@..@@@...@..
@@@@...@@@.@@@...@..
@@@....@...@.....@..
.......@..@@.@@..@@.
...@.@....@@..@.@...
..@.@.@@..@@@@..@.@.
......@.@.@.....@.@@
.@@...@..@..@.@....@
@@......@@.@.@..@@..
@@..@@.@.@@.....@@..
@..@@@....@@.@..@@..
..@@@..@@@....@@@@..
.@@.@@...@.......@@.
..@.@.@.@.@.@@.@@@@.
@.....@.....@@@@....
.@...@@@..@@@.......
...@@...@...@@@...@.
@..@..@@.......@...@
@@....@@@.@.@@.@..@@
@...@.@@@.@.@@@@....
