20,20
...........@........
....................
........@@..........
....................
...........@@.......
@...................
....@.....@.@.......
....................
.....@.@............
.......@..........@.
....................
....................
@...................
....................
....................
....................
.@..................
.......@.@.....@....
............@.......
@...................
