20,20
.....@.....@@.......
.@.................@
.@..................
....@@....@......@..
....................
......@...@.....@..@
.....@.............@
....@..............@
.....@..............
.......@............
......@.............
....................
...@............@...
..........@.........
.....@.....@....@.@.
.......@............
.@....@.............
....@@...@.........@
...@.............@.@
....@...........@...
