20,20
....................
........@....@......
....................
....@...........@...
.....@...@....@.....
.@.............@@...
....................
....................
....................
...................@
..@...............@.
....................
....................
.@..................
............@.......
......@............@
....................
....................
.................@..
.@..........@.......
