20,20
....@@@.....@@@@.@.@
@.........@.........
....@...............
.....@..@.@.........
................@...
..@.................
@@..@.......@.@..@@.
.@..@.@@@@@@........
.@.@.@......@@......
..@.....@..........@
.@...@.......@..@.@.
.......@..@.........
...@.@..@...........
...@...........@....
......@...@@@..@.@@.
...........@@.@.....
....@@@..@...@.....@
........@......@@.@.
.@...@..@@...@...@..
............@..@....
