20,20
........@@........@.
@@@.@.@@@@.@@@@@@.@.
@@@@@...@@.@@@@.....
@..@@@......@@@@@@@.
@...@.@@.@@.@..@@...
@...@.@@.@@...@@@@@.
..@.......@@@.@@....
.@@@@@@@..@.@.@@@@.@
@@@..@@@@...@.@..@.@
@...@@.@@....@@@....
..@.@@.@.@.@@@.@.@.@
@@@........@.....@.@
....@..@@@@@@@@@@@..
.@.@@@@@@@.@.@@@@...
.@..@@@.......@...@@
@@.@....@@.@@@@@.@@@
@@...@@.@@@.@......@
@@.@@@@.@@..@@@@.@.@
@@@@....@@..@@@.@...
@@...@@......@.....@
