20,20
....@@....@@@.....@@
@.@.@@@@@.....@@@...
.@@.@@@@.@...@@..@@@
..@..@.@.@.@....@@@@
@.@.........@.@..@.@
....@@.@..@.@@@@@...
..@.@@..@@@@..@@..@@
.@@.@.@@@@.@........
..@@@....@.@@..@@@@@
...@.@.@.@......@@.@
.@@@..@..@@@..@.....
...@...@.@@...@@@@@@
@@..........@...@@@.
...@@.@@@.@.@..@@@..
@@@...@....@@.@....@
.@@.@@@.@..@@...@..@
..@..@..@.@@@.@.@.@@
.@@.@.@..@@....@@.@.
....@.@.@@@.@@.@@...
.@@...@.@...@@@@@@..
