20,20
@.@@..@.@@@@.@..@.@.
..@........@........
.@.@..@.@@.@...@.@@.
....@@@.@....@.@@.@@
@.@...@....@@@@@..@@
@.@@@.@.......@..@@.
..@@......@@@@...@..
....@.@..@....@.@@.@
.@..@.@.@@.@@@@.@@.@
.@...@.......@..@@..
..@..@.@@@.@...@.@.@
...@.@.@..@...@@....
..@.@...@...@.@.@@.@
@@...@@..@@@@...@...
..@@.@@.@@.@@......@
.@@@...@.......@.@.@
.@@..@..@@.@....@@@@
....@....@.@.@.@@...
..@@...@...@.@....@.
....@@@@....@@@@@@..
