20,20
@@.........@..@@....
.....@....@........@
@.......@.......@@..
.@....@.@@@@........
.@..@@@@.@@.........
..@..@@@.@.......@.@
@.@..@....@...@@.@@.
.......@@@@@@.@.@...
...@...@...@.@....@.
.........@@...@...@.
@..@...@..@.@.......
@.....@..@.@....@...
.@....@......@@@..@.
....@@..@..@@......@
..@.@....@@......@.@
.@...@.....@@.@.@.@.
.....@..@@@...@...@.
..@..@...@@.@@@.@...
@...@..@.....@.....@
@.@..@.@@@..@@..@...
