20,20
...........@.....@@@
@..@.@.@..........@.
@@@@.@.@@..@.@..@...
.@......@..@@@.@@.@.
..@@@@...@@@.....@..
...@...@@@@@@.@@@...
@................@..
.........@.@@@@@..@@
..@.....@@.@.@@@@..@
@...@@@..@@....@.@..
..@.@@@@@.@@.@@...@.
...@@...@...........
@...@.......@.@.....
.@..@..@...@..@...@.
..@@.@@..@.@...@@..@
.......@.@@..@..@@..
....@....@@...@@@@..
@@@.@.....@@........
@.@.@......@......@@
....@@@.@..@...@@@@@
