20,20
..............@.....
.................@..
....................
...................@
............@.......
......@..@..........
.......@............
...................@
.....@..............
@.............@.....
..@.................
....................
@...................
@...................
....@...............
..........@.........
......@.............
...@................
..........@......@..
....................
