20,20
@.@...@.@.....@@....
..@@.....@.@...@.@@.
............@.@..@@@
.@.....@..@..@.....@
.@.@@@.@@..@@.@.@@.@
@...@.@..@@.......@.
...@.......@..@..@..
@...@..@@@.@..@@@...
@@..@.....@@@......@
....@......@.@......
@...@........@.@..@.
@....@.@.@.@.@@@.@..
.........@.@.......@
...@@@.@.@@....@...@
@....@@......@@@@...
.@@.........@.@@..@.
.....@...@@...@.@.@.
.@..@.@.@.....@...@.
......@..@@......@..
.@...............@..
