20,20
...@.......@@@..@...
@@.@..@...@.....@.@.
.......@@...@@.@@..@
.@.@.@...@..@.@@....
..@...@.........@...
.@..................
.....@..@...@....@..
..@..@..@.@.........
.@...@..@@....@.@...
..@@..@..@..@.....@@
......@.@..........@
..@...@@....@......@
.@..@....@..........
@..@..@.@.......@.@@
..........@...@..@..
.....@.@.....@@...@.
..@...@@@@.@...@.@..
@.......@...........
....@@@.....@@.@..@.
@......@.@@@......@.
