20,20
..@@..@@.@@@.......@
@..@.@......@@.@.@@@
.........@@@.@.@....
@@.@...@......@.@@@.
@@@...@......@@.....
..@.@...@@..@....@@.
@...@.@@@.@......@@@
@.@@@...@.@..@.@.@..
..@...@@@....@@@...@
@..@@..@.@@@@@...@@@
.....@...@@...@..@@@
...@@..@@.@.@...@.@.
.@@@@.@@..@.@.......
.@@@..@@.@@@@....@.@
@.....@.....@@@@@@.@
@..@.........@....@@
..@@.@@@..@@...@@...
...@@..@@.@@.@@@@@.@
@@.@@....@.@@.@.....
...@..............@.
