20,20
.@@.@.@......@@@@@@.
..........@@.@..@.@.
..@.@.@...@@.@..@...
.@.@.@..@..@@@@...@.
@....@@.@....@.....@
@...@@@@@....@@@.@..
@@.......@@....@.@.@
@@..@..@@.@@.....@..
.@.@....@..@.@..@@@.
...@@.@...@@....@@..
@@@@..@@@@..@..@.@.@
@@@@....@......@.@..
.@.@@@.@..@@..@...@.
....@..@...@..@.@@@.
@@...@...@..@@@..@@@
@@@..@@@....@...@@@@
@.....@..@@....@..@.
@..@@.....@.@@.@@.@.
@...@..@..@..@..@...
@@...@@...@..@......
