20,20
@@@@.@@@@@@@@@..@@..
..@...@...@@@@@.....
@...@...@@.@@@@@@.@.
@.@@@@@.@@......@.@.
@@@...@....@@@@.@.@@
@@@.@..@@.@@@.@...@.
@@@..@@@..@....@.@..
.........@@@@..@.@..
.@.@.@.@...@.@...@@.
@@..@@.@@.@..@..@@@.
@@@@@@.@@...@.@...@.
@@@@....@@@.@....@@.
..@@@.@...@@@@.@@...
@..@@@@@.@@@@@...@.@
@..@@@........@@@@..
..@@@...@.@@@...@@@.
@.@...@@@.@@@@@.....
....@@@@@.@..@...@@@
.@....@.@@@@...@...@
@@@@@.......@@.@@@.@
