20,20
@@@.@@@..@.....@@@@@
.@@..@@@.@.@@@.@....
.@@@........@@.@@.@.
.@...@@.@.@.@....@@.
..@@@@@.@@@@@@.@@.@.
@..@......@@@@@@@.@.
...@.@@.@.@@........
.@.@..@.@.@@@@.@@.@.
@..@..@@@.@....@..@.
@....@@.@@..@@@..@@.
@.@@.....@@@....@@@.
@.@@@@.@.@@@@@@@@...
@...@@@@@@....@..@.@
@.@@@@.@@..@@..@...@
@.@@@@..@...@@...@@@
.......@@@@.@..@....
..@@@@..@@@@@.@.@.@@
.@@........@@...@.@@
..@.@.@.@@....@@@...
...@@@@@@@.@.@@@@.@@
