20,20
......@@..@@......@@
@...@@@@@..@@@@..@..
.@@.@.......@@.@.@..
.@@.....@.@.@....@@.
.@.@@....@@.@@@@..@.
....@..@@@@..@......
@.....@@.....@@@.@.@
....@@@@.@@@..@@@@.@
.@.@@@@...@@..@@...@
..@@@@@@@@.@.@@@.@..
..@..@@@......@@.@@@
@...@@.@@@@@.@@..@.@
@.@.@@....@...@@.@..
...@.@.@@.@..@@@...@
@@...@...@.@......@.
....@@.@.....@@@....
@@.@.@.@.@@@.@@..@@@
.@....@@.@@@@@...@@@
....@..@...@@@..@...
@@..@@.@@@..@@....@.
