20,20
.@..@...............
........@...........
......@.....@.......
@.@@..@...@.........
....@@.@....@.....@.
.........@.......@..
@.....@..@...@..@...
....@...........@...
....@.@.........@..@
@...@.....@.@......@
@..@................
.........@...@......
@@......@...........
......@........@@...
@...........@.......
.................@@@
.@..@...............
..@@...@.@..........
@....@.@............
.........@@.....@...
