20,20
@@.@@@@@@@@@@...@@@@
@@......@@..@@@.@...
@@@@.......@@@@...@@
@@@..@.@@@.@@...@@.@
..@@@..@@@@@@@@.@..@
@.@@@@....@.....@.@@
..@@..@@@...@@.@@..@
@....@.@@@@@.@.@@@.@
@.@@.............@..
@.@@.@@@@.@.@.@....@
@.@@.....@@@@@@.@.@@
@...@@@@@@@@@@@.@...
@..@@@.@@@@@@@@.@@@.
..@.@@.@.....@...@@.
@@@.@....@@@.@@.@@@@
@...@.@.@@@.....@@.@
..@...@@@@@.@@@..@.@
@@.@..@@@@@.@@@@....
@@....@@.......@@.@.
@@.@@@@@@.@@@@.@@.@@
