20,20
@...@@@....@@.....@@
@...@.....@@.....@@@
@.@.@.@..@@.....@...
......@.@.@@@.@@@.@.
.@@...@...@@..@....@
.@.@@@@@.@@......@..
@@...@...@@.@@@...@.
@.......@@@..@..@@@.
.@...@@@@.....@@..@@
...@@.@...@@.....@@.
..@.......@...@@@@..
....@..@@@@@..@....@
@.@.@@@....@@..@.@..
@.@...@.@@..@.@...@.
.@@...@.@...@...@..@
....@...@.@@@..@@@@@
@..@..@.@@.@..@..@@@
.....@@.@..@.@@..@@.
.@.@.@@..@.@........
.@.@.@@@...@.@...@..
