20,20
@@@@@@@@@@@@@@@@@@@.
@.....@@@@@.@@.@@@@.
@.@.@.@@@@@....@@@@.
@.@.@.@@.@@@@@..@@..
..@.@.@...@@@@@....@
@@@.@@@.@.@.....@@@@
@@@.....@...@@@..@@@
@@..@.@@@@@@@@@@....
@@.@@..@@@@@@@@@@@@@
@@@@@@....@@..@@@@@@
@@@@@@.@@@@..@@@@@@@
@@@@@@.@@@..@@......
.@.@@@.....@@..@@@.@
...@@..@@@....@@@@.@
@@....@@@@.@@@@@@@.@
@@.@@@@@@...@@.....@
@@.@..@@@.@.@@.@@@..
@@.@@.....@.@...@@@.
@@@@@.@@@@@.@@@.@@@.
@@@@@@@@@@@@@@@@@@@@
