20,20
.@....@.@@.@.@@..@@@
.@.@@@@....@.@@@...@
.@.@@@@@.@...@@@.@.@
....@....@@@@....@..
@@@...@@@@@@@..@.@@.
@@@.@@...@@...@@.@@@
.....@@@.@...@.....@
@.@@.@@@...@.@@@..@@
..@@..@@@@@....@....
.@@.@..@.@@.@.@@@@@.
.@@...@@....@.@@@@@.
@@..@....@@.@.@...@@
@@...@.@@@@@@@..@...
...@@@.@@.@@.@.@@@.@
@@.@@........@..@@..
@...@@@.@.@@...@@..@
@.@.@@@@@..@@..@@.@@
@.@..@..@@.@@@@@..@.
..@@....@...@....@..
..@@@@...@@@@@.@...@
