20,20
.@.@....@@@@@@......
.@....@@@.......@@.@
......@..@@..@@..@..
@..@@...@@..@@..@@@@
..@@....@@...@...@..
.@...@.....@@..@.@@.
@..@@@@@.....@@@@...
@@..@@...@@@@@@..@..
....@@@...@.@@@....@
..@...@..@@......@..
.@..@@.@@..@@.@@.@.@
@@.........@@@@..@..
@..@.@..@.....@.@@@.
@.@@.@@@...@...@....
...@...@@...@@...@@@
..@@.@.@..@...@.....
...@@@@..@.....@@.@.
......@.@@..@.@@..@@
...@@..@.@@@@@...@@.
@....@...@@@@@......
