20,20
@..@....@...@...@.@.
........@..@........
@.@.@..@.........@.@
......@...@.@@....@@
.@@...@............@
.............@....@@
@.......@...@.......
..@@@@..@.@........@
..@........@@...@...
.@@.@...........@@.@
........@..@.@@.....
...@....@@@...@.@...
...@...@...@.@@.....
...@........@.@..@@.
....@.@.@.@.@.......
@...@..@..@@........
@.@....@...@...@.@..
....@@..@...........
...@....@.@.@@.@@..@
...@..@..@...@.@@...
