20,20
@.........@...@@..@.
@.@.@..@....@.....@.
@..@....@.@.@.@...@.
.@.@....@...........
.@@.@.@@..@@.@@@.@..
.@....@...@........@
...@.@..@@.@.@.@@..@
..@.@.@@@...@@.@..@@
@...@......@@.......
.@@..@...@@@@...@@@@
...@@..@..@@...@@...
@@..@@@..@..........
.........@@@.@......
@@.@@...@.@@.@..@@.@
.@@.@.@.@......@.@.@
........@.....@@....
.@.@.@.....@@.@.@.@.
..@..@@.@@...@......
..@....@.@@..@.@@..@
@.@@.@.@.....@.@@@..
