20,20
@@@@@@...@...@@@@@.@
@@@.@@@@.@@@.@.....@
@...@@@....@...@@@@@
@@..@@@.@@...@@@@@..
@@@.@.....@@.@@@@@.@
@.@...@@.@@@..@@@@.@
....@@@@.@@@@...@@.@
.@@@@..@.@@@@@@.@..@
.@@@@@......@@@...@@
.@@@@@.@@.@@@@@.@@@@
@@@@@@..@..@.......@
@@@@@@@.@..@.@@@.@@@
@@@@@.@.@@.@..@@.@..
@.@.....@@.@@.@..@.@
....@.@@@@.@@.@@...@
.@@@@...@@..@..@@@.@
....@@@..@@.@@@@@..@
@.@@@@..@@@.@@@@@.@@
@.@@@@.@@@@..@......
@@@@@...@@@@@@@@@@@@
