20,20
.@...@@....@.......@
.........@.......@..
.@...........@......
.@@..@..............
..@...@....@...@...@
.............@......
@.......@.....@.....
.................@..
@@..........@......@
......@@.....@....@.
.......@...@.....@..
.@.@@.@..@@@........
.@@..@.......@..@@..
...........@........
.@@@....@...........
....................
....@...@........@..
............@......@
.....@...@......@...
...@................
