20,20
................@...
....................
...........@.....@..
....................
....................
.....@..............
..........@.........
.......@......@.....
............@.......
....................
...........@........
....@...............
......@.............
..........@.....@...
...........@........
...............@...@
....................
.@.@................
............@.......
..................@.
