20,20
@.@@@@..@@@@.@@..@.@
@.@.@.@....@.....@.@
@.@....@..@.@@@..@..
@.@..@@@@.....@....@
@...@@.......@@.@.@@
@@@.@.....@@.@@@@...
....@.@@@..@@@.@.@.@
.@@...@@@..@.@.@...@
.@..@.@@.....@.....@
.@@@@..@...@.@@.@@.@
.@@@@@..@....@@...@@
.@@@@...@..@..@@@..@
.@.@..@@@...@..@...@
@........@..@....@.@
@@...@.@@@@@..@@@.@@
.@...@..@@.@@.@.@.@@
...@.@..@..@@......@
@@.@.@@@..@@@...@..@
@..@@@@@@..@@..@@.@@
@@......@.....@.....
